Netuno=Neptuno
abatista=abaptista
abjeção=abjecção
acetilação=aceptilação
acetor=aceptor
adotante=adoptante
adotar=adoptar
adotação=adoptação
adotivamente=adoptivamente
adotivo=adoptivo
afeção=afecção
anabatismo=anabaptismo
anabatista=anabaptista
anatrético=anatréptico
androlético=androléptico
anticeticismo=anticepticismo
anticoncetivo=anticonceptivo
anticético=anticéptico
antiepilético=antiepiléptico
antimetalético=antimetaléptico
antissético=antisséptico
anótico=anóptico
apercetibilidade=aperceptibilidade
apocaliticismo=apocalipticismo
apocalítico=apocalíptico
atar=aptar
ateira=apteira
ateruro=apteruro
atitude=aptitude
ato=apto
atração=atracção
atrético=atréptico
autoinfeção=autoinfecção
bata=bapta
batismo=baptismo
batista=baptista
batistino=baptistino
batistério=baptistério
bijeção=bijecção
birrefração=birrefracção
bisseção=bissecção
biótico=bióptico
catabatismo=catabaptismo
catabatista=catabaptista
catador=captador
catalético=cataléptico
catar=captar
ceticismo=cepticismo
circunspeção=circunspecção
coatar=coaptar
concetibilidade=conceptibilidade
concetismo=conceptismo
concetista=conceptista
concetiva=conceptiva
concetividade=conceptividade
concetualismo=conceptualismo
concetualista=conceptualista
concetualizar=conceptualizar
concetualização=conceptualização
concetualmente=conceptualmente
concetáculo=conceptáculo
confeção=confecção
conspeção=conspecção
contracetivo=contraceptivo
contrarrutura=contrarruptura
correto=correpto
corruta=corrupta
corrutela=corruptela
corrutibilidade=corruptibilidade
corruto=corrupto
corrutor=corruptor
corrutora=corruptora
cota=copta
coto=copto
critófago=criptófago
crítico=críptico
cético=céptico
defeção=defecção
dejeção=dejecção
derrelição=derrelicção
desinfeção=desinfecção
deteção=detecção
disseção=dissecção
dição=dicção
dítico=díptico
eclítica=eclíptica
efração=efracção
ejeção=ejecção
eletro-ótica=eletro-óptica
eletrótica=eletróptica
epilética=epiléptica
epilético=epiléptico
estrição=estricção
estupefação=estupefacção
estético=estéptico
euroceticismo=eurocepticismo
eurocética=eurocéptica
eurocético=eurocéptico
eurotimismo=europtimismo
exceto=excepto
excetuador=exceptuador
excetuar=exceptuar
excetuável=exceptuável
exsução=exsucção
exterocetor=exteroceptor
extrojeção=extrojecção
extrospeção=extrospecção
fação=facção
fotorrecetor=fotorreceptor
fração=fracção
heteroinfeção=heteroinfecção
hético=héptico
impação=impacção
impercetibilidade=imperceptibilidade
impercetivelmente=imperceptivelmente
imputrefação=imputrefacção
inato=inapto
incorrutibilidade=incorruptibilidade
incorrutível=incorruptível
infeção=infecção
inflição=inflicção
infração=infracção
inteleção=intelecção
intercetador=interceptador
intercetar=interceptar
intercetação=interceptação
intercetor=interceptor
intercetório=interceptório
interrutor=interruptor
interseção=intersecção
introjeção=introjecção
introspeção=introspecção
intuspeção=intuspecção
isótero=isóptero
letão=leptão
lipossução=lipossucção
liquefação=liquefacção
metamorfótico=metamorfóptico
multinfeção=multinfecção
narcolético=narcoléptico
necrótico=necróptico
netunismo=neptunismo
netunista=neptunista
netúnio=neptúnio
objeção=objecção
olfação=olfacção
oticidade=opticidade
oticista=opticista
oticometria=opticometria
oticómetro=opticómetro
otimacia=optimacia
otimamente=optimamente
otimate=optimate
otimismo=optimismo
otimista=optimista
otimizar=optimizar
otimização=optimização
otografia=optografia
otográfico=optográfico
paralítico=paralíptico
parótico=paróptico
percetibilidade=perceptibilidade
percetivamente=perceptivamente
percetivelmente=perceptivelmente
percetividade=perceptividade
perceto=percepto
político=políptico
precetista=preceptista
precetivamente=preceptivamente
precetor=preceptor
precetorado=preceptorado
precetoria=preceptoria
procatalético=procataléptico
proleticamente=prolepticamente
prolético=proléptico
propriocetor=proprioceptor
prospeção=prospecção
putrefação=putrefacção
quimiorrecetividade=quimiorreceptividade
quimiorrecetor=quimiorreceptor
radiorrecetor=radiorreceptor
rarefação=rarefacção
ratado=raptado
ratar=raptar
rato=rapto
readotar=readoptar
rebatismo=rebaptismo
recetador=receptador
recetar=receptar
recetação=receptação
recetibilidade=receptibilidade
recetiva=receptiva
recetividade=receptividade
recetor=receptor
recetáculo=receptáculo
recoleção=recolecção
refração=refracção
reinfeção=reinfecção
resseção=ressecção
retador=reptador
reto=repto
retrospeção=retrospecção
reção=recção
rutura=ruptura
seta=septa
setempedano=septempedano
setena=septena
setenado=septenado
setenato=septenato
setenvirado=septenvirado
setenvirato=septenvirato
setenário=septenário
setilião=septilião
setimano=septimano
setimestre=septimestre
setingentésimo=septingentésimo
setissílabo=septissílabo
seto=septo
setuagenária=septuagenária
setuagenário=septuagenário
setuagésima=septuagésima
setuagésimo=septuagésimo
setupleta=septupleta
setuplicar=septuplicar
setênviro=septênviro
seção=secção
sinoticamente=sinopticamente
sinótico=sinóptico
subjeção=subjecção
subseção=subsecção
superinfeção=superinfecção
suscetibilidade=susceptibilidade
suscetibilizar=susceptibilizar
suscetível=susceptível
sução=sucção
sétula=séptula
sétuplo=séptuplo
teledeteção=teledetecção
telerrecetor=telerreceptor
terópode=pterópode
tilose=ptilose
torrefação=torrefacção
transcetor=transceptor
trisseção=trissecção
tumefação=tumefacção
tármico=ptármico
ténio=pténio
tênio=ptênio
vivisseção=vivissecção
volutuar=voluptuar
volutuosa=voluptuosa
volutuosamente=voluptuosamente
volutuosidade=voluptuosidade
volutuoso=voluptuoso
zoótico=zoóptico
ático=áptico
ótica=óptica
ótico=óptico
ótimo=óptimo