Otávio=Octávio
Vitório=Victório
abjetamente=abjectamente
abjeto=abjecto
acantodátilo=acantodáctilo
acataleto=acatalecto
acepção=aceção
ateu=acteu
atino=actino
atínia=actínia
acupuntor=acupunctor
acupuntura=acupunctura
acupunturador=acupuncturador
acupuntural=acupunctural
acupunturar=acupuncturar
acupunturação=acupuncturação
ad-retal=ad-rectal
adatilia=adactilia
aditício=adictício
adopção=adoção
adátilo=adáctilo
afetadamente=afectadamente
afetado=afectado
afetador=afectador
afetar=afectar
afetativo=afectativo
afetação=afectação
afetivamente=afectivamente
afetividade=afectividade
afetivo=afectivo
afeto=afecto
afetuosamente=afectuosamente
afetuosidade=afectuosidade
afetível=afectível
afilático=afiláctico
amiotático=amiotáctico
aneletródio=anelectródio
anelétrodo=aneléctrodo
anitérico=anictérico
anisodatilia=anisodactilia
anisodátilo=anisodáctilo
anorético=anoréctico
anti-itérico=anti-ictérico
antiatático=antiatáctico
antidátilo=antidáctilo
antiferroelétrico=antiferroeléctrico
antiprático=antipráctico
antropotático=antropotáctico
antártia=antárctia
antártico=antárctico
apercepção=aperceção
apodítica=apodíctica
apotático=apotáctico
aquapuntura=aquapunctura
aquapunturar=aquapuncturar
artícola=arctícola
arquitetonicamente=arquitectonicamente
artefato=artefacto
artiodátilo=artiodáctilo
aspeto=aspecto
aspetual=aspectual
atarático=ataráctico
bibliofilático=bibliofiláctico
bicaraterística=bicaracterística
bissetar=bissectar
bissetor=bissector
bissetriz=bissectriz
braquicataleto=braquicatalecto
braquicatalético=braquicataléctico
bronquetático=bronquectático
cato=cacto
calatino=calactino
calefator=calefactor
carateristicamente=caracteristicamente
caraterizador=caracterizador
caraterizadora=caracterizadora
caraterizante=caracterizante
caraterizar=caracterizar
caraterização=caracterização
caraterizável=caracterizável
caraterologia=caracterologia
caraterológico=caracterológico
caraterística=característica
caraterístico=característico
cardiopuntura=cardiopunctura
caráter=carácter
catafilático=catafiláctico
cataleto=catalecto
catalético=cataléctico
circunspetamente=circunspectamente
circunspeto=circunspecto
citofilático=citofiláctico
citopético=citopéctico
climatérico=climactérico
climatério=climactério
climático=climáctico
coatar=coactar
coativamente=coactivamente
coatividade=coactividade
coator=coactor
coartada=coarctada
coartar=coarctar
coartação=coarctação
coto=cocto
codialeto=codialecto
cofator=cofactor
coleta=colecta
coletar=colectar
coletivamente=colectivamente
coletividade=colectividade
coletivismo=colectivismo
coletivista=colectivista
coletivizar=colectivizar
coletivização=colectivização
coletivo=colectivo
coletor=colector
coletoria=colectoria
coletário=colectário
coletânea=colectânea
colopético=colopéctico
concepção=conceção
conetividade=conectividade
conetivo=conectivo
conetor=conector
conjetura=conjectura
conjeturabilidade=conjecturabilidade
conjeturador=conjecturador
conjeturalmente=conjecturalmente
conjeturante=conjecturante
conjeturar=conjecturar
conjeturista=conjecturista
conjetânea=conjectânea
conspeto=conspecto
contatar=contactar
contato=contacto
contracepção=contraceção
contratilidade=contractilidade
contrativo=contractivo
contrato=contracto
contratura=contractura
contraturante=contracturante
contratível=contractível
contrafator=contrafactor
contrátil=contráctil
convetor=convector
corretismo=correctismo
corretivamente=correctivamente
correpção=correção
correspetivo=correspectivo
corrupção=corrução
cristalelétrico=cristaleléctrico
tonismo=ctonismo
datilado=dactilado
datilar=dactilar
datiliografia=dactiliografia
datiliográfico=dactiliográfico
datiliologia=dactiliologia
datiliológico=dactiliológico
datiliomancia=dactiliomancia
datiliomante=dactiliomante
datiliomântico=dactiliomântico
datilioteca=dactilioteca
datiliólogo=dactiliólogo
datilofasia=dactilofasia
datilografado=dactilografado
datilografar=dactilografar
datilografia=dactilografia
datilograficamente=dactilograficamente
datilograma=dactilograma
datilográfico=dactilográfico
datilologia=dactilologia
datilológico=dactilológico
datilomancia=dactilomancia
datilomante=dactilomante
datilomântico=dactilomântico
datilonomia=dactilonomia
datiloscopia=dactiloscopia
datiloscópico=dactiloscópico
datiloteca=dactiloteca
datilozoide=dactilozoide
datilozoário=dactilozoário
datilógrafa=dactilógrafa
datilógrafo=dactilógrafo
datilólobo=dactilólobo
datilóptero=dactilóptero
decadátilo=decadáctilo
decepção=deceção
defetibilidade=defectibilidade
defetividade=defectividade
defletir=deflectir
defletográfico=deflectográfico
defletor=deflector
defletível=deflectível
defletógrafo=deflectógrafo
defletômetro=deflectômetro
dejetar=dejectar
dejeto=dejecto
dejetório=dejectório
desafetadamente=desafectadamente
desafetar=desafectar
desafetação=desafectação
desafeto=desafecto
descaraterizado=descaracterizado
descaraterizar=descaracterizar
descaraterização=descaracterização
desconetar=desconectar
deseletrizar=deselectrizar
desinfetador=desinfectador
desinfetante=desinfectante
desinfetar=desinfectar
desinfetável=desinfectável
desinfetório=desinfectório
detetabilidade=detectabilidade
detetar=detectar
detetiva=detectiva
detetive=detective
detetor=detector
deítico=deíctico
dialetalmente=dialectalmente
dialeticamente=dialecticamente
dialetismo=dialectismo
dialetista=dialectista
dialetizar=dialectizar
dialetização=dialectização
dialeto=dialecto
dialetologia=dialectologia
dialetologista=dialectologista
dialetólogo=dialectólogo
dialética=dialéctica
dialético=dialéctico
ditafone=dictafone
ditamno=dictamno
didaticamente=didacticamente
didatologia=didactologia
didatológico=didactológico
dielétrico=dieléctrico
difratómetro=difractómetro
difratômetro=difractômetro
dislético=disléctico
disorético=disoréctico
dissetor=dissector
distático=distáctico
duto=ducto
dátilo=dáctilo
dêitico=dêictico
dítico=díctico
efetivador=efectivador
efratura=efractura
ejetar=ejectar
ejetor=ejector
ejetólito=ejectólito
eletracústica=electracústica
eletrargol=electrargol
eletrencefalografia=electrencefalografia
eletrencefalograma=electrencefalograma
eletrete=electrete
eletrexecução=electrexecução
eletricamente=electricamente
eletrificador=electrificador
eletrificar=electrificar
eletrificação=electrificação
eletrizador=electrizador
eletrizar=electrizar
eletrização=electrização
eletro-óptica=electro-óptica
eletrobalística=electrobalística
eletrobiologia=electrobiologia
eletrobiológico=electrobiológico
eletrobomba=electrobomba
eletrocardiografia=electrocardiografia
eletrocardiograma=electrocardiograma
eletrocardiógrafo=electrocardiógrafo
eletrochoque=electrochoque
eletrocinética=electrocinética
eletrocirurgia=electrocirurgia
eletrocoagulação=electrocoagulação
eletrocultura=electrocultura
eletrocussão=electrocussão
eletrocutar=electrocutar
eletrocutir=electrocutir
eletrocutor=electrocutor
eletrodeposição=electrodeposição
eletrodiagnóstico=electrodiagnóstico
eletrodinamismo=electrodinamismo
eletrodinamômetro=electrodinamômetro
eletrodinâmica=electrodinâmica
eletrodiálise=electrodiálise
eletrodoméstico=electrodoméstico
eletroencefalografia=electroencefalografia
eletroencefalograma=electroencefalograma
eletroencefalógrafo=electroencefalógrafo
eletrofisiologia=electrofisiologia
eletrofone=electrofone
eletroforese=electroforese
eletroformação=electroformação
eletrofotografia=electrofotografia
eletrogalvanismo=electrogalvanismo
eletrogenético=electrogenético
eletrogerador=electrogerador
eletrografia=electrografia
eletrogênese=electrogênese
eletrolisador=electrolisador
eletrolisar=electrolisar
eletrolisação=electrolisação
eletrolisável=electrolisável
eletrologia=electrologia
eletroluminescência=electroluminescência
eletrológico=electrológico
eletromagnete=electromagnete
eletromagnetismo=electromagnetismo
eletromecânico=electromecânico
eletromeopatia=electromeopatia
eletrometalurgia=electrometalurgia
eletrometalúrgico=electrometalúrgico
eletrometria=electrometria
eletromiografia=electromiografia
eletromiograma=electromiograma
eletromotor=electromotor
eletronegatividade=electronegatividade
eletronicamente=electronicamente
eletropexia=electropexia
eletropositividade=electropositividade
eletropunctura=electropunctura
eletroquímica=electroquímica
eletrorradiologia=electrorradiologia
eletrorradiologista=electrorradiologista
eletroscopia=electroscopia
eletroscópio=electroscópio
eletrossemáforo=electrossemáforo
eletrosserra=electrosserra
eletrossiderurgia=electrossiderurgia
eletrossiderúrgico=electrossiderúrgico
eletrossoldadura=electrossoldadura
eletrostrição=electrostrição
eletrostática=electrostática
eletrotanásia=electrotanásia
eletrotecnia=electrotecnia
eletroterapeuta=electroterapeuta
eletroterapia=electroterapia
eletroterapêutica=electroterapêutica
eletroterapêutico=electroterapêutico
eletrotermia=electrotermia
eletroterápico=electroterápico
eletrotipia=electrotipia
eletrotropia=electrotropia
eletrotropismo=electrotropismo
eletrotrópico=electrotrópico
eletrotécnico=electrotécnico
eletrotípico=electrotípico
eletrovalência=electrovalência
eletrovegetômetro=electrovegetômetro
eletrovital=electrovital
eletrovitalismo=electrovitalismo
eletrozônio=electrozônio
eletroímã=electroímã
eletrão=electrão
eletríman=electríman
eletródio=electródio
eletrófilo=electrófilo
eletróforo=electróforo
eletrógrafo=electrógrafo
eletrólise=electrólise
eletrólito=electrólito
eletróptica=electróptica
eletrótipo=electrótipo
eletrômero=electrômero
eletrômetro=electrômetro
eletrônica=electrônica
eletrônio=electrônio
eletuário=electuário
eletropuntura=eletropunctura
elétrico=eléctrico
elétrino=eléctrino
elétrodo=eléctrodo
elétron=eléctron
epata=epacta
eretamente=erectamente
eretida=erectida
eretilidade=erectilidade
eretor=erector
erétil=eréctil
espetaculozinho=espectaculozinho
espetaculozito=espectaculozito
espetador=espectador
espetadora=espectadora
espetar=espectar
espetral=espectral
espetralidade=espectralidade
espetro=espectro
espetrofobia=espectrofobia
espetrofotometria=espectrofotometria
espetrofotométrico=espectrofotométrico
espetrofotómetro=espectrofotómetro
espetrofotômetro=espectrofotômetro
espetrografia=espectrografia
espetrograma=espectrograma
espetrográfico=espectrográfico
espetrologia=espectrologia
espetrológico=espectrológico
espetrometria=espectrometria
espetrométrico=espectrométrico
espetroscopia=espectroscopia
espetroscopista=espectroscopista
espetroscópico=espectroscópico
espetroscópio=espectroscópio
espetrozinho=espectrozinho
espetrozito=espectrozito
espetrógrafo=espectrógrafo
espetrómetro=espectrómetro
espetrômetro=espectrômetro
esplenenfrático=esplenenfráctico
esplenopético=esplenopéctico
estenodatilógrafo=estenodactilógrafo
estupefativo=estupefactivo
estupefator=estupefactor
exatamente=exactamente
exator=exactor
expetador=expectador
expetante=expectante
expetantismo=expectantismo
expetar=expectar
expetativa=expectativa
expetatório=expectatório
expetação=expectação
expetorante=expectorante
expetorar=expectorar
expetoração=expectoração
expetável=expectável
extratar=extractar
extrativo=extractivo
extrato=extracto
extrator=extractor
fato=facto
fator=factor
fatorial=factorial
fatorizar=factorizar
fatura=factura
fito=ficto
filocato=filocacto
fletir=flectir
fletômetro=flectômetro
flitena=flictena
fonético-sintaticamente=fonético-sintacticamente
fonético-sintático=fonético-sintáctico
foteletrão=fotelectrão
fotodielétrico=fotodieléctrico
fotoeletrão=fotoelectrão
fototatismo=fototactismo
fratura=fractura
fraturamento=fracturamento
fraturar=fracturar
funtor=functor
fático=fáctico
galvanopuntura=galvanopunctura
gastropético=gastropéctico
genufletir=genuflectir
genufletor=genuflector
haptotatismo=haptotactismo
heticidade=hecticidade
heliotatismo=heliotactismo
hemiatático=hemiatáctico
hemotético=hemotéctico
hepatopético=hepatopéctico
heptadátilo=heptadáctilo
heterodátilo=heterodáctilo
heterorrético=heterorréctico
heterotático=heterotáctico
hidroelétrica=hidroeléctrica
hidroextrator=hidroextractor
hidrofrático=hidrofráctico
hidrotatismo=hidrotactismo
hipercataleto=hipercatalecto
hipercatalético=hipercataléctico
hiperdialético=hiperdialéctico
hipereutético=hipereutéctico
hipeutético=hipeutéctico
hipodátilo=hipodáctilo
hipotático=hipotáctico
histeropético=histeropéctico
holantártico=holantárctico
homeocataleto=homeocatalecto
homeocatalético=homeocataléctico
hética=héctica
hético=héctico
iterícia=icterícia
itérica=ictérica
itérico=ictérico
idioleto=idiolecto
ignipuntura=ignipunctura
imperfetibilidade=imperfectibilidade
imperfetivelmente=imperfectivelmente
imperfetividade=imperfectividade
imunoeletroforese=imunoelectroforese
incarateristicamente=incaracteristicamente
incaraterizado=incaracterizado
incaraterizável=incaracterizável
incaraterístico=incaracterístico
indefetibilidade=indefectibilidade
indefetivelmente=indefectivelmente
induto=inducto
inefetivo=inefectivo
infetado=infectado
infetar=infectar
infeto=infecto
infetologia=infectologia
infetológico=infectológico
infetuosidade=infectuosidade
infetável=infectável
infletir=inflectir
infrator=infractor
injeto=injecto
injetor=injector
inobjetividade=inobjectividade
inopético=inopéctico
inseticida=insecticida
inseticídio=insecticídio
insetiforme=insectiforme
inseto=insecto
insetologia=insectologia
insetologista=insectologista
insetológico=insectológico
insetário=insectário
insetífero=insectífero
insetívoro=insectívoro
insetófilo=insectófilo
insurreto=insurrecto
intatilidade=intactilidade
intercepção=interceção
interjetivamente=interjectivamente
intersetar=intersectar
intuscepção=intusceção
intuspetivamente=intuspectivamente
intussuscepção=intussusceção
intátil=intáctil
invetiva=invectiva
invetivador=invectivador
invetivante=invectivante
invetivar=invectivar
invetivista=invectivista
iselétrico=iseléctrico
isodatilia=isodactilia
jatanciar=jactanciar
jatanciosidade=jactanciosidade
jatar=jactar
jato=jacto
jatoplanador=jactoplanador
jatura=jactura
jatância=jactância
latente=lactente
latescência=lactescência
laticínio=lacticínio
litor=lictor
liquefativo=liquefactivo
liquefator=liquefactor
látea=láctea
lático=láctico
macrodatilia=macrodactilia
macrodátilo=macrodáctilo
magnetelétrico=magneteléctrico
malático=maláctico
manifato=manifacto
manufato=manufacto
manufator=manufactor
manufatura=manufactura
manufaturador=manufacturador
manufaturar=manufacturar
manufaturação=manufacturação
megalodatilia=megalodactilia
melocato=melocacto
mesorreto=mesorrecto
metapetina=metapectina
metapético=metapéctico
microbjetiva=microbjectiva
microeletrônica=microelectrônica
mito=micto
multissetorial=multissectorial
mórfico-sintático=mórfico-sintáctico
neto=necto
nefropético=nefropéctico
notívago=noctívago
objetante=objectante
objetar=objectar
objetiva=objectiva
objetivador=objectivador
objetivamente=objectivamente
objetivar=objectivar
objetivação=objectivação
objetividade=objectividade
objetivismo=objectivismo
objetivista=objectivista
objetivo=objectivo
objetivável=objectivável
objetologia=objectologia
objetologista=objectologista
objetológico=objectológico
objetor=objector
objetora=objectora
objetólogo=objectólogo
oticista=octicista
otávia=octávia
otóforo=octóforo
olfatar=olfactar
olfativamente=olfactivamente
olfato=olfacto
olfatometria=olfactometria
olfatométrico=olfactométrico
olfatório=olfactório
olfatômetro=olfactômetro
olfática=olfáctica
orquiopético=orquiopéctico
patear=pactear
pato=pacto
paleártica=paleárctica
paleártico=paleárctico
paquidatilia=paquidactilia
paraelétrico=paraeléctrico
paralaticamente=paralacticamente
paralático=paraláctico
paralético=paraléctico
paraplético=parapléctico
parapoplético=parapopléctico
parapético=parapéctico
parelétrico=pareléctrico
percepção=perceção
perfetibilidade=perfectibilidade
perfetibilismo=perfectibilismo
perfetibilista=perfectibilista
perfetibilizar=perfectibilizar
perfetivação=perfectivação
perfetividade=perfectividade
perfuntoriamente=perfunctoriamente
perirretite=perirrectite
perissodátilo=perissodáctilo
perspetiva=perspectiva
perspetival=perspectival
perspetivar=perspectivar
perspetivação=perspectivação
perspetividade=perspectividade
perspetivismo=perspectivismo
perspetivista=perspectivista
perspetográfico=perspectográfico
perspetógrafo=perspectógrafo
pito=picto
pletro=plectro
pneumoplético=pneumopléctico
pneumopético=pneumopéctico
polidatilia=polidactilia
polipletro=poliplectro
polissindátilo=polissindáctilo
preconcepção=preconceção
protoplástico=proctoplástico
profilaticamente=profilacticamente
profilatismo=profilactismo
projetozinho=projectozinho
projetozito=projectozito
prolético=proléctico
prospetar=prospectar
prospetiva=prospectiva
prospeto=prospecto
prospetor=prospector
prossetor=prossector
prostatopético=prostatopéctico
protrátil=protráctil
pré-adopção=pré-adoção
pseudodialetal=pseudodialectal
pterodátilo=pterodáctilo
puntura=punctura
putrefativo=putrefactivo
putrefator=putrefactor
quimiorrecepção=quimiorreceção
quimiotatismo=quimiotactismo
rarefatibilidade=rarefactibilidade
rarefativo=rarefactivo
rarefator=rarefactor
rarefatível=rarefactível
reatância=reactância
readopção=readoção
recepção=receção
recoleta=recolecta
recoleto=recolecto
retal=rectal
retangularidade=rectangularidade
retangularmente=rectangularmente
retidão=rectidão
retificador=rectificador
retificar=rectificar
retificação=rectificação
retifloro=rectifloro
retilineamente=rectilineamente
retilinearidade=rectilinearidade
retilíneo=rectilíneo
retiparalelinérveo=rectiparalelinérveo
retite=rectite
retitude=rectitude
reto=recto
retocele=rectocele
retocolite=rectocolite
retopexia=rectopexia
retor=rector
retoscopia=rectoscopia
retoscópio=rectoscópio
retotomia=rectotomia
retovesical=rectovesical
retriz=rectriz
returetral=recturetral
retângulo=rectângulo
reeletrômetro=reelectrômetro
refletividade=reflectividade
refletografia=reflectografia
refletográfico=reflectográfico
refletométrico=reflectométrico
refletómetro=reflectómetro
refletômetro=reflectômetro
refratar=refractar
refratariamente=refractariamente
refratarismo=refractarismo
refratividade=refractividade
refrator=refractor
refratoscópico=refractoscópico
refratoscópio=refractoscópio
refratário=refractário
refratômetro=refractômetro
regioleto=regiolecto
reotático=reotáctico
respetivamente=respectivamente
respetivo=respectivo
retratilidade=retractilidade
retrativamente=retractivamente
retrativo=retractivo
retrato=retracto
retrofletir=retroflectir
retrospetiva=retrospectiva
retrospetivamente=retrospectivamente
retrospetividade=retrospectividade
retrospeto=retrospecto
retrátil=retráctil
revindita=revindicta
rito=ricto
rinenfrático=rinenfráctico
setor=sector
setorial=sectorial
setorizar=sectorizar
setorização=sectorização
simplético=simpléctico
sindatilia=sindactilia
sindátilo=sindáctilo
sintaticamente=sintacticamente
sintaticista=sintacticista
socioleto=sociolecto
subacepção=subaceção
subdialetal=subdialectal
subdialeto=subdialecto
subiterícia=subicterícia
subitérico=subictérico
subsetor=subsector
tateabilidade=tacteabilidade
tateadamente=tacteadamente
tateamento=tacteamento
tatear=tactear
tateio=tacteio
taticamente=tacticamente
taticografia=tacticografia
taticográfico=tacticográfico
taticógrafo=tacticógrafo
tatilidade=tactilidade
tatilmente=tactilmente
tatismo=tactismo
tato=tacto
tatura=tactura
talitro=talictro
tecnoleto=tecnolecto
teto=tecto
tetriz=tectriz
tetônica=tectônica
teledetetar=teledetectar
teleobjetiva=teleobjectiva
telespetador=telespectador
telobjetiva=telobjectiva
tenontopético=tenontopéctico
tenopético=tenopéctico
termodielétrico=termodieléctrico
termotatismo=termotactismo
termotático=termotáctico
tetradatilia=tetradactilia
tetradátilo=tetradáctilo
tiflopético=tiflopéctico
tigmotatismo=tigmotactismo
torrefator=torrefactor
transator=transactor
traquelopético=traquelopéctico
tricorrético=tricorréctico
tridátilo=tridáctilo
trissetor=trissector
trissetriz=trissectriz
trofotatismo=trofotactismo
tática=táctica
tático=táctico
tátil=táctil
técnico-tático=técnico-táctico
ureterenfrático=ureterenfráctico
uretrofrático=uretrofráctico
uretrorretal=uretrorrectal
vaginorretal=vaginorrectal
vetação=vectação
vetor=vector
vetorizar=vectorizar
venipuntura=venipunctura
ventifato=ventifacto
veredito=veredicto
vesicorretal=vesicorrectal
vice-coletor=vice-colector
vindita=vindicta
vivissetor=vivissector
vivissetora=vivissectora
zigodátilo=zigodáctilo
zigotatismo=zigotactismo
zoelétrico=zoeléctrico
zooelétrico=zooeléctrico
ártico=árctico
