dezesseis=dezasseis
dezessete=dezassete
dezenove=dezanove
islã=islão
Vietnã=Vietname
Amsterdã=Amesterdão
xenônio=xénon
volfrâmio=wolfrâmio
verossímil=verosímil
verossímile=verosímile
verossimilhança=verosimilhança
verossimilhante=verosimilhante
verossimilidade=verosimilidade
verossimílimo=verosimílimo
verossimilitude=verosimilitude
vedete=vedeta
vedetes=vedetas
terremoto=terramoto
terremotos=terramotos
Teerã=Teerão
Chechênia=Tchetchénia
tcheca=checa
tcheco=checo
tchecas=checas
tchecos=checos
rúgbi=râguebi
próton=protão
próton=protãos
radônio=rádon
pornô=porno
pornôs=pornos
pôquer=póquer
pôqueres=póqueres
planejamento=planeamento
planejamentos=planeamentos
planejar=planear
onicolor=omnicolor
onipotente=omnipotente
onipotentes=omnipotentes
onipresença=omnipresença
onipresenças=omnipresenças
onipresente=omnipresente
onipresentes=omnipresentes
onisciente=omnisciente
oniscientes=omniscientes
oganessônio=oganésson
Netuno=Neptuno
nêutron=neutrão
nêutrons=neutrões
netúnio=neptúnio
Moscou=Moscovo
Mônaco=Mónaco
matusalênica=matusalénica
matusalênicas=matusalénicas
matusalênico=matusalénico
matusalênicos=matusalénicos
lépton=leptão
léptons=leptões
Iugoslávia=Jugoslávia
Irã=Irão
Ilhas Maurício=Ilhas Maurícias
ilhas Maurício=ilhas Maurícias
hormônio=hormona
hormônios=hormonas
à toa=à-toa
absenteísmo=absentismo
aiatolá=aiatola
aiatolás=aiatolas
alho-poró=alho-porro
alhos-porós=alhos-porros
ambrosia=ambrósia
anistia=amnistia
anistias=amnistias
anticódon=anticodão
anticódons=anticodões
aquarela=aguarela
aquarelas=aguarelas
aquarelar=aguarelar
barion=barião
barions=bariões
brócolis=brócolos
canadense=canadiano
canadenses=canadianos
câncer=cancro
cânceres=cancros
Câncer=Caranguejo
carcinogénia=cancerígena
carcinogênia=cancerígena
carcinogénias=cancerígenas
carcinogênias=cancerígenas
carcinogênica=carcinogénica
carcinogênicas=carcinogénicas
carcinogênio=cancerígeno
carcinogénio=cancerígeno
carcinogênios=cancerígenos
carcinogénios=cancerígenos
Caribe=Caraíbas
cátion=catião
cátions=catiões
códon=codão
códons=codões
Copenhague=Copenhaga
Djibuti=Jibuti
esôfago=esófago
esôfagos=esófagos
férmion=fermião
férmions=fermiões
fóton=fotão
fótons=fotões
gêiser=géiser
gêisers=géiseres
geodésia=geodesia
geodésias=geodesias
glúon=gluão
glúons=gluões
gráviton=gravitão
grávitons=gravitões
handbol=andebol
handebol=andebol
Helsinque=Helsínquia
indenização=indemnização
indenizações=indemnizações
indenizar=indemnizar
Madri=Madrid
panamenho=panamiano
panamenhos=panamianos
panamenha=panamiana
panamenhas=panamianas
páprica=paprica
pápricas=papricas
pósitron=positrão
pósitrons=positrões
árgon=argônio
xampu=champô
xampus=champôs
caminhão=camião
caminhões=camiões
elétron=eletrão
elétrons=eletrões
jôquer=jóquer
jôqueres=jóqueres
buldôzer=buldózer
buldôzeres=buldózeres
pôster=póster
pôsteres=pósteres
umente=humente
umentes=humentes
ebola=ébola
Groenlândia=Gronelândia
groenlandês=gronelandês
groenlandeses=gronelandeses
groenlandesa=gronelandesa
groenlandesas=gronelandesas