Ortografia Antiga	Ortografia Nova
ab-reacção	ab-reação
ab-reactivo	ab-reativo
abaptista	abatista
abjecção	abjeção
abjeccionista	abjecionista
abjectamente	abjetamente
abjecto	abjeto
Abril	abril
abrotanóide	abrotanoide
abstracção	abstração
abstraccionismo	abstracionismo
abstraccionista	abstracionista
abstracta	abstrata
abstractamente	abstratamente
abstractício	abstratício
abstractismo	abstratismo
abstractivamente	abstrativamente
abstractivismo	abstrativismo
abstractivo	abstrativo
abstractizado	abstratizado
abstractizante	abstratizante
abstractizar	abstratizar
abstracto	abstrato
abstractor	abstrator
abutilóide	abutiloide
acantóide	acantoide
acantozóide	acantozoide
acaróide	acaroide
acatalecto	acataleto
acatéctico	acatético
acção	ação
accionabilidade	acionabilidade
accionadamente	acionadamente
accionado	acionado
accionador	acionador
accional	acional
accionamento	acionamento
accionar	acionar
accionário	acionário
accionável	acionável
accionista	acionista
accipitrário	accipitrário, acipitrário
accipitrídeo	accipitrídeo, acipitrídeo
accipitrino	accipitrino, acipitrino
acepção	aceção
aceptor	acetor
acha-de-armas	acha de armas
acta	ata
actinóide	actinoide
activa	ativa
activação	ativação
activado	ativado
activador	ativador
activamente	ativamente
activante	ativante
activar	ativar
activável	ativável
actividade	atividade
activismo	ativismo
activíssimo	ativíssimo
activista	ativista
activo	ativo
acto	ato
actor	ator
actor-encenador	ator-encenador
actriz	atriz
actuação	atuação
actuador	atuador
actual	atual
actualidade	atualidade
actualismo	atualismo
actualíssimo	atualíssimo
actualista	atualista
actualização	atualização
actualizado	atualizado
actualizador	atualizador
actualizante	atualizante
actualizar	atualizar
actualizável	atualizável
actualmente	atualmente
actuante	atuante
actuar	atuar
actuária	atuária
actuariado	atuariado
actuarial	atuarial
actuário	atuário
actuável	atuável
actuosamente	atuosamente
actuosidade	atuosidade
actuoso	atuoso
açúcar-de-madeira	açúcar de madeira
acupunctor	acupuntor, acupunctor
acupunctura	acupuntura, acupunctura
acupuncturação	acupunturação, acupuncturação
acupuncturador	acupuncturador, acupunturador
acupunctural	acupuntural, acupunctural
acupuncturar	acupunturar, acupuncturar
acutibóia	acutiboia
acutimbóia	acutimboia
ad-rectal	ad-retal, ad-rectal
adenóide	adenoide
adjecção	adjeção
adjectivação	adjetivação
adjectivado	adjetivado
adjectival	adjetival
adjectivalização	adjetivalização
adjectivamente	adjetivamente
adjectivamento	adjetivamento
adjectivar	adjetivar
adjectivável	adjetivável
adjectividade	adjetividade
adjectivo	adjetivo
adjectivo-particípio	adjetivo-particípio
adjecto	adjeto
adopção	adoção
adopcianismo	adocianismo
adopciano	adociano
adopcionismo	adocionismo
adoptação	adotação
adoptado	adotado
adoptante	adotante
adoptar	adotar
adoptável	adotável
adoptiva	adotiva
adoptivamente	adotivamente
adoptivo	adotivo
aeróide	aeroide
afecção	afeção
afeccional	afecional
afeccionalidade	afecionalidade
afectação	afetação
afectada	afetada
afectadamente	afetadamente
afectado	afetado
afectador	afetador
afectante	afetante
afectar	afetar
afectativo	afetativo
afectável	afetável
afectivamente	afetivamente
afectível	afetível
afectividade	afetividade
afectivo	afetivo
afecto	afeto
afectuosamente	afetuosamente
afectuosidade	afetuosidade
afectuoso	afetuoso
afiláctico	afilático
aftóide	aftoide
agatóide	agatoide
agnostozóico	agnostozoico
Agosto	agosto
agro-alimentar	agroalimentar
agro-ambiental	agroambiental
agro-florestal	agroflorestal
agro-indústria	agroindústria
agro-industrial	agroindustrial
agro-pecuária	agropecuária
agro-pecuário	agropecuário
agro-químico	agroquímico
agro-turismo	agroturismo
água-de-força	água de força
água-de-lume	água de lume
água-de-mesa	água de mesa
água-de-végeto	água de végeto
ajudante-de-campo	ajudante de campo
ajudante-de-ordens	ajudante de ordens
alantóide	alantoide
albóio	alboio
albuminóide	albuminoide
alcalino-gasoso	alcalinogasoso
alcalino-terroso	alcalinoterroso
alcalóide	alcaloide
alfinete-de-ama	alfinete de ama
algodão-das-laranjeiras	algodão das laranjeiras
algodão-das-oliveiras	algodão das oliveiras
algodão-de-vidro	algodão de vidro
algodão-em-rama	algodão em rama
algóide	algoide
alisfenóide	alisfenoide
alma-do-padeiro	alma do padeiro
almécega-do-brasil	almécega do brasil
almorróida	almorroida
alocróico	alocroico
ama-de-leite	ama de leite
amebóide	ameboide
amebóides	ameboides
amiantóide	amiantoide
amibóide	amiboide
amibóides	amiboides
amigo-da-onça	amigo da onça
amilóide	amiloide
amiotáctico	amiotático
amonóide	amonoide
amonóides	amonoides
amplectivo	ampletivo
anabaptismo	anabatismo
anabaptista	anabatista
anafiláctico	anafilático
anapnóico	anapnoico
anaptíctico	anaptítico
anarco-sindicalista	anarcossindicalista
ancilóide	anciloide
anciróide	anciroide
andrenóide	andrenoide
androginóide	androginoide
andróide	androide
androléptico	androlético
anecóico	anecoico
aneléctrico	anelétrico
anelectródio	aneletródio
aneléctrodo	anelétrodo
anepiplóico	anepiploico
aneróide	aneroide
aneuplóide	aneuploide
anfibolóide	anfiboloide
angiectático	angietático
angu-de-caroço	angu de caroço
anguilóide	anguiloide
anictérico	anictérico, anitérico
anjo-da-guarda	anjo da guarda
anóptico	anótico
anoréctico	anorético
antárctia	antártia
antárctico	antártico
antasfíctico	antasfítico
anteacto	anteato
anteprojecto	anteprojeto
anteróide	anteroide
anterozóide	anterozoide
anti-heróico	anti-heroico
anti-ictérico	anti-ictérico, anti-itérico
anti-infecciosamente	anti-infeciosamente
anti-infeccioso	anti-infecioso
anti-rábico	antirrábico
anti-racional	antirracional
anti-racionalismo	antirracionalismo
anti-racionalista	antirracionalista
anti-racismo	antirracismo
anti-racista	antirracista
anti-raquítico	antirraquítico
anti-real	antirreal
anti-realismo	antirrealismo
anti-realista	antirrealista
anti-reflexo	antirreflexo
anti-reformismo	antirreformismo
anti-reformista	antirreformista
anti-regiões	antirregiões
anti-regionalista	antirregionalista
anti-regionalização	antirregionalização
anti-regulamentar	antirregulamentar
anti-religioso	antirreligioso
anti-republicana	antirrepublicana
anti-republicanismo	antirrepublicanismo
anti-republicano	antirrepublicano
anti-ressonância	antirressonância
anti-retroviral	antirretroviral
anti-reumático	antirreumático
anti-reumatismal	antirreumatismal
anti-revisionismo	antirrevisionismo
anti-revisionista	antirrevisionista
anti-revolução	antirrevolução
anti-revolucionária	antirrevolucionária
anti-revolucionário	antirrevolucionário
anti-roubo	antirroubo
anti-rugas	antirrugas
anti-salazarista	antissalazarista
anti-sátira	antissátira
anti-semita	antissemita
anti-semítico	antissemítico
anti-semitismo	antissemitismo
anti-sepsia	antissepsia
anti-sepsiador	antissepsiador
anti-sepsiar	antissepsiar
anti-séptico	antisséptico, antissético
anti-sezonático	antissezonático
anti-sialagogo	antissialagogo
anti-siálico	antissiálico
anti-sida	antissida
anti-sifilítico	antissifilítico
anti-sigma	antissigma
anti-simbólico	antissimbólico
anti-sinodal	antissinodal
anti-sísmico	antissísmico
anti-sistema	antissistema
anti-social	antissocial
anti-socialismo	antissocialismo
anti-socialista	antissocialista
anti-sociável	antissociável
anti-sofista	antissofista
anti-soro	antissoro
anti-soviético	antissoviético
anti-submarino	antissubmarino
anti-subversão	antissubversão
anti-sudoral	antissudoral
anti-sudorífico	antissudorífico
antiapopléctico	antiapoplético
antiatáctico	antiatático
anticaquéctico	anticaquético
anticepticismo	anticeticismo
anticéptico	anticético
anticoncepcional	anticoncecional
anticonceptivo	anticoncetivo
antiepiléptico	antiepilético
antiferroelectricidade	antiferroeletricidade
antiferroeléctrico	antiferroelétrico
antimetaléptico	antimetalético
antipráctico	antiprático
antracóide	antracoide
antropóide	antropoide
antropotáctico	antropotático
antropozóico	antropozoico
apercepção	aperceção
aperceptibilidade	apercetibilidade
aperceptível	apercetível
aperceptivo	apercetivo
apocalipticismo	apocaliticismo
apocalíptico	apocalíptico, apocalítico
apodíctica	apodítica
apodíctico	apodítico
apomíctico	apomítico
apopléctico	apoplético
aposséptico	apossético
apotáctico	apotático
apráctico	aprático
aquapunctura	aquapuntura, aquapunctura
aquapuncturar	aquapunturar, aquapuncturar
arabóia	araboia
aracnóide	aracnoide
araçóia	araçoia
ararabóia	araraboia
ararambóia	araramboia
arazóia	arazoia
arco-da-aliança	arco da aliança
arco-da-chuva	arco da chuva
arco-de-deus	arco de Deus
árctico	ártico
arctícola	artícola
arefacção	arefação
argilóide	argiloide
aritenóide	aritenoide
arqueozóico	arqueozoico
arqueozóico	arqueozoico
arqui-rabino	arquirrabino
arqui-rival	arquirrival
arqui-rivalidade	arquirrivalidade
arqui-sacerdote	arquissacerdote
arqui-são	arquissão
arqui-sátrapa	arquissátrapa
arqui-secular	arquissecular
arqui-senescal	arquissenescal
arqui-sinagoga	arquissinagoga
arqui-sistro	arquissistro
arqui-sofista	arquissofista
arquitecta	arquiteta
arquitectação	arquitetação
arquitectar	arquitetar
arquitectável	arquitetável
arquitecto	arquiteto
arquitectónica	arquitetónica
arquitectonicamente	arquitetonicamente
arquitectónico	arquitetónico
arquitectonografia	arquitetonografia
arquitectonográfico	arquitetonográfico
arquitectonógrafo	arquitetonógrafo
arquitector	arquitetor
arquitectura	arquitetura
arquitectural	arquitetural
arquitecturismo	arquiteturismo
arquitecturista	arquiteturista
arroz-de-cuxá	arroz de cuxá
arruda-dos-muros	arruda dos muros
árvore-da-vida	árvore da vida
asbestóide	asbestoide
aspecto	aspeto
aspectual	aspectual
asplenióide	asplenioide
asséptico	asséptico, assético
assimptota	assimptota, assintota
assimptótico	assimptótico, assintótico
assimptotismo	assintotismo, assimptotismo
assintáctico	assintático
assumpcionista	assuncionista
asteróide	asteroide
astragalóide	astragaloide
astróide	astroide
atlóide	atloide
atracção	atração
atractivamente	atrativamente
atractividade	atratividade
atractivo	atrativo
aurifactório	aurifatório
auto-abastecer	autoabastecer
auto-acusação	autoacusação
auto-adesivo	autoadesivo
auto-administração	autoadministração
auto-administrar	autoadministrar
auto-administrável	autoadministrável
auto-admiração	autoadmiração
auto-ajuda	autoajuda
auto-análise	autoanálise
auto-aplicável	autoaplicável
auto-avaliação	autoavaliação
auto-de-fé	auto de fé
auto-educação	autoeducação
auto-educativo	autoeducativo
auto-elogio	autoelogio
auto-emprego	autoemprego
auto-endireitável	autoendireitável
auto-escada	autoescada
auto-escola	autoescola
auto-estima	autoestima
auto-estrada	autoestrada
auto-excitação	autoexcitação
auto-excitar	autoexcitar
auto-excluir	autoexcluir
auto-executável	autoexecutável
auto-imagem	autoimagem
auto-imposição	autoimposição
auto-imposto	autoimposto
auto-imune	autoimune
auto-imunidade	autoimunidade
auto-imunização	autoimunização
auto-inculpação	autoinculpação
auto-indução	autoindução
auto-indulgência	autoindulgência
auto-indulgente	autoindulgente
auto-infecção	autoinfeção
auto-intitulado	autointitulado
auto-intoxicação	autointoxicação
auto-rádio	autorrádio
auto-radiografia	autorradiografia
auto-radiográfico	autorradiográfico
auto-referencial	autorreferencial
auto-reflexão	autorreflexão
auto-regulação	autorregulação
auto-regulador	autorregulador
auto-retrato	autorretrato
auto-satisfação	autossatisfação
auto-serviço	autosserviço
auto-suficiência	autossuficiência
auto-suficiente	autossuficiente
auto-sugestão	autossugestão
auto-sugestionar	autossugestionar
auto-sugestionável	autossugestionável
auto-suspender	autossuspender
auto-suspenso	autossuspenso
auto-sustentável	autossustentável
autocorrecção	autocorreção
autocorrectivo	autocorretivo
autocorrector	autocorretor
autodidacta	autodidata
autodidáctica	autodidática
autodidacticamente	autodidaticamente
autodidáctico	autodidático
autodidactismo	autodidatismo
autoprojecção	autoprojeção
autoprojector	autoprojetor
autoprotecção	autoproteção
autotractor	autotrator
axifóide	axifoide
axóide	axoide
azeite-de-cheiro	azeite de cheiro
azeite-de-pau	azeite de pau
azóico	azoico
azulóio	azuloio
baba-de-camelo	baba de camelo
baba-de-moça	baba de moça
bairro-de-lata	bairro de lata
balanóide	balanoide
balão-de-ensaio	balão de ensaio
bálsamo-do-canadá	bálsamo do Canadá
balsamóide	balsamoide
banabóia	banaboia
baptismal	batismal
baptismo	batismo
baptista	batista
baptistério	batistério
baptistino	batistino
baptizado	batizado
baptizamento	batizamento
baptizando	batizando
baptizante	batizante
baptizar	batizar
baptizo	batizo
barba-de-baleia	barba de baleia
barca-de-ouro	barca de ouro
barotáctico	barotático
barriga-de-bicho	barriga de bicho
barriga-de-freira	barriga de freira
basiopinacóide	basiopinacoide
basipinacóide	basipinacoide
batracóide	batracoide
beijo-de-moça	beijo de moça
belemnóide	belemnoide
belonóide	belonoide
Beltrano	beltrano
benzóico	benzoico
beróide	beroide
betóia	betoia
bibliofiláctico	bibliofilático
bicaracterística	bicaracterística, bicaraterística
bicha-de-rabear	bicha de rabear
bicha-de-sete-cabeças	bicha de sete cabeças
bicho-de-sete-cabeças	bicho de sete cabeças
bicho-do-buraco	bicho do buraco
bicho-do-mato	bicho do mato
bicho-do-ouvido	bicho do ouvido
bico-de-gás	bico de gás
bico-de-gavião	bico de gavião
bico-de-mocho	bico de mocho
bico-de-obra	bico de obra
bico-de-pato	bico de pato
bidireccional	bidirecional
bife-de-caneca	bife de caneca
bijecção	bijeção
bilhete-de-identidade	bilhete de identidade
bilhete-de-visita	bilhete de visita
bioactividade	bioatividade
bioactivo	bioativo
biobjectividade	biobjetividade
biobjectivo	biobjetivo
biocolóide	biocoloide
bioelectricidade	bioeletricidade
bioeléctrico	bioelétrico
bioflavonóide	bioflavonoide
biotáctico	biotático
birreactor	birreator
birrefracção	birrefração
bissector	bissetor, bissector
bissectriz	bissetriz
bissóide	bissoide
blastóides	blastoides
boca-de-favas	boca de favas
boca-de-fogo	boca de fogo
boca-de-incêndio	boca de incêndio
boca-de-sino	boca de sino
boca-de-siri	boca de siri
bóia	boia
bóia-fria	boia-fria
boioçubóia	boioçuboia
bola-ao-cesto	bola ao cesto
bom-de-bico	bom de bico
bota-de-elástico	bota de elástico
botrióide	botrioide
braço-de-armas	braço de armas
braço-de-ferro	braço de ferro
branco-de-baleia	branco de baleia
braquicataléctico	braquicatalético
braquicatalecto	braquicataleto
braquióide	braquioide
braquipinacóide	braquipinacoide
bronquectásico	bronquetásico
bronquectático	bronquetático
bubonóide	bubonoide
cabeça-de-abóbora	cabeça de abóbora
cabeça-de-alho-chocho	cabeça de alho chocho
cabeça-de-asno	cabeça de asno
cabeça-de-avelã	cabeça de avelã
cabeça-de-burro	cabeça de burro
cabeça-de-carneiro	cabeça de carneiro
cabeça-de-cartaz	cabeça de cartaz
cabeça-de-casal	cabeça de casal
cabeça-de-cavalo	cabeça de cavalo
cabeça-de-lista	cabeça de lista
cabeça-de-motim	cabeça de motim
cabeça-de-pau	cabeça de pau
cabeça-de-ponte	cabeça de ponte
cabeça-de-porco	cabeça de porco
cabeça-de-secção	cabeça de secção
cabeça-de-série	cabeça de série
cabeça-de-tremoço	cabeça de tremoço
cabeça-de-turco	cabeça de turco
cabeça-de-vento	cabeça de vento
cabeça-no-ar	cabeça no ar
cabo-de-esquadra	cabo de esquadra
cabo-de-guerra	cabo de guerra
cacabóia	cacaboia
cacto	cato
cactóide	cactoide
caixa-de-ar	caixa de ar
caixa-de-música	caixa de música
caixa-de-óculos	caixa de óculos
caixa-de-ressonância	caixa de ressonância
caixa-de-rufo	caixa de rufo
caixa-dos-pirolitos	caixa dos pirolitos
calamóide	calamoide
calcóide	calcoide
calefacção	calefação
calefactor	calefator
calefactório	calefatório
câmara-de-ar	câmara de ar
caminho-de-ferro	caminho de ferro
camisa-de-força	camisa de força
camisa-de-forças	camisa de forças
camisa-de-onze-varas	camisa de onze varas
camisa-de-vénus	camisa de Vénus
camisa-do-pano	camisa do pano
cana-de-roca	cana de roca
canal-da-areia	canal da areia
cancróide	cancroide
canforóide	canforoide
canto-de-cisne	canto de cisne
canto-do-cisne	canto do cisne
capa-de-chuva	capa de chuva
capitão-de-bandeira	capitão de bandeira
capitão-de-corveta	capitão de corveta
capitão-de-fragata	capitão de fragata
capitão-de-mar-e-guerra	capitão de mar e guerra
capróico	caproico
caquecticamente	caqueticamente
caquéctico	caquético
cara-de-pau	cara de pau
carácter	caráter, carácter
caracterial	caracterial, caraterial
característica	característica, caraterística
caracteristicamente	caracteristicamente, carateristicamente
característico	característico, caraterístico
caracterização	caracterização, caraterização
caracterizador	caracterizador, caraterizador
caracterizadora	caracterizadora, caraterizadora
caracterizante	caracterizante, caraterizante
caracterizar	caracterizar, caraterizar
caracterizável	caracterizável, caraterizável
caracterológico	caracterológico, caraterológico
carcinóide	carcinoide
cardióide	cardioide
cardiopunctura	cardiopuntura, cardiopunctura
cardiorréctico	cardiorrético
carne-de-sol	carne de sol
carotenóide	carotenoide
carreira-de-tiro	carreira de tiro
carta-de-prego	carta de prego
cartão-de-visita	cartão de visita
casca-de-noz	casca de noz
catabaptismo	catabatismo
catabaptista	catabatista
catafiláctico	catafilático
cataléctico	catalético
catalecto	cataleto
catarréctico	catarrético
catenóide	catenoide
cavalo-de-batalha	cavalo de batalha
cavalo-de-frisa	cavalo de frisa
cavalo-do-cão	cavalo do cão
cefalóide	cefaloide
celulóide	celuloide
Cenozóico	Cenozoico
centro-de-mesa	centro de mesa
céptica	cética
cepticismo	ceticismo
céptico	cético
ceptrífero	cetrífero
ceptrígero	cetrígero
ceptro	cetro
ceratóide	ceratoide
cerebróide	cerebroide
ceróide	ceroide
cestóide	cestoide
céu-da-boca	céu da boca
chacóina	chacoina
chapéu-de-chuva	chapéu de chuva
chapéu-de-sol	chapéu de sol
chefe-de-fila	chefe de fila
chirimóia	chirimoia
ciamóide	ciamoide
cianóide	cianoide
ciatóide	ciatoide
ciclóide	cicloide
cicnóide	cicnoide
cilindróide	cilindroide
cinoréctico	cinorético
cióptico	ciótico
circunspecção	circunspeção
circunspeccionar	circunspecionar
circunspectamente	circunspectamente, circunspetamente
circunspecto	circunspecto, circunspeto
cirróide	cirroide
cirsóide	cirsoide
cissóide	cissoide
cisticercóide	cisticercoide
cistiocercóide	cistiocercoide
cistióide	cistioide
cistóide	cistoide
citofiláctico	citofilático
citóide	citoide
citopéctico	citopético
clarabóia	claraboia
clidorréctico	clidorrético
clinóide	clinoide
clinopinacóide	clinopinacoide
co-acusado	coacusado
co-administração	coadministração
co-administrador	coadministrador
co-administradora	coadministradora
co-administrar	coadministrar
co-aluno	coaluno
co-apóstolo	coapóstolo
co-arguida	coarguida
co-arguido	coarguido
co-arrendador	coarrendador
co-arrendamento	coarrendamento
co-arrendar	coarrendar
co-arrendatária	coarrendatária
co-arrendatário	coarrendatário
co-associado	coassociado
co-autor	coautor
co-autora	coautora
co-autoria	coautoria
co-credor	cocredor
co-credora	cocredora
co-criador	cocriador
co-criadora	cocriadora
co-delinquência	codelinquência
co-delinquente	codelinquente
co-delinquir	codelinquir
co-demandante	codemandante
co-demandista	codemandista
co-descobridor	codescobridor
co-detentor	codetentor
co-devedor	codevedor
co-devedora	codevedora
co-dialecto	codialeto
co-direcção	codireção
co-director	codiretor
co-directora	codiretora
co-dirigir	codirigir
co-dominância	codominância
co-dominante	codominante
co-donatário	codonatário
co-editar	coeditar
co-eleitor	coeleitor
co-eremita	coeremita
co-esposa	coesposa
co-esposo	coesposo
co-eternidade	coeternidade
co-eterno	coeterno
co-evangelista	coevangelista
co-fiador	cofiador
co-fiadora	cofiadora
co-financiado	cofinanciado
co-financiador	cofinanciador
co-financiadora	cofinanciadora
co-financiamento	cofinanciamento
co-financiar	cofinanciar
co-fundador	cofundador
co-gerência	cogerência
co-gerente	cogerente
co-gerir	cogerir
co-gestão	cogestão
co-igual	coigual
co-incineração	coincineração
co-incineradora	coincineradora
co-incinerar	coincinerar
co-inquilino	coinquilino
co-interessado	cointeressado
co-latitude	colatitude
co-legado	colegado
co-legatária	colegatária
co-legatário	colegatário
co-legislativo	colegislativo
co-leitor	coleitor
co-licitante	colicitante
co-litigação	colitigação
co-litigante	colitigante
co-litigar	colitigar
co-logaritmo	cologaritmo
co-mediador	comediador
co-obrigado	coobrigado
co-obrigar	coobrigar
co-ocorrência	coocorrência
co-ocorrente	coocorrente
co-ocupante	coocupante
co-opositor	coopositor
co-organizado	coorganizado
co-parceiro	coparceiro
co-participação	coparticipação
co-participante	coparticipante
co-participar	coparticipar
co-patrocinador	copatrocinador
co-piloto	copiloto
co-presidência	copresidência
co-presidente	copresidente
co-principado	coprincipado
co-príncipe	copríncipe
co-procurador	coprocurador
co-produção	coprodução
co-produtor	coprodutor
co-produtora	coprodutora
co-produzir	coproduzir
co-propriedade	copropriedade
co-proprietária	coproprietária
co-proprietário	coproprietário
co-protector	coprotetor
co-ré	corré
co-redactor	corredator
co-redenção	corredenção
co-redentor	corredentor
co-referência	correferência
co-referente	correferente
co-regência	corregência
co-regente	corregente
co-responsabilidade	corresponsabilidade
co-responsabilização	corresponsabilização
co-responsabilizar	corresponsabilizar
co-responsável	corresponsável
co-réu	corréu
co-secante	cossecante
co-seno	cosseno
co-signatária	cossignatária
co-signatário	cossignatário
co-tangente	cotangente
co-texto	cotexto
co-tutela	cotutela
co-tutor	cotutor
co-tutora	cotutora
co-utente	coutente
co-variante	covariante
co-vendedor	covendedor
co-vidente	covidente
coacção	coação
coactar	coatar
coáctil	coátil
coactivamente	coativamente
coactividade	coatividade
coactivo	coativo
coactor	coator
coactora	coatora
coanóide	coanoide
coarctação	coartação
coarctada	coartada
coarctar	coartar
coarctativo	coartativo
cofactor	cofator
cóia	coia
cóio	coio
colecção	coleção
coleccionação	colecionação
coleccionador	colecionador
coleccionadora	colecionadora
coleccionar	colecionar
coleccionável	colecionável
coleccionismo	colecionismo
coleccionista	colecionista
coleccionístico	colecionístico
colecta	coleta
colectânea	coletânea
colectâneo	coletâneo
colectar	coletar
colectário	coletário
colectável	coletável
colectício	coletício
colectivamente	coletivamente
colectividade	coletividade
colectivismo	coletivismo
colectivista	coletivista
colectivístico	coletivístico
colectivização	coletivização
colectivizar	coletivizar
colectivo	coletivo
colector	coletor
colectora	coletora
colectoria	coletoria
colete-de-forças	colete de forças
colóide	coloide
colopéctico	colopético
colorrectite	colorretite
combóia	comboia
comida-de-urso	comida de urso
comprotector	comprotetor
concepção	conceção
concepcional	concecional
concepcionário	concecionário
conceptaculífero	concetaculífero
conceptáculo	conceptáculo, concetáculo
conceptibilidade	conceptibilidade, concetibilidade
conceptismo	conceptismo, concetismo
conceptista	conceptista, concetista
conceptístico	conceptístico, concetístico
conceptiva	conceptiva, concetiva
conceptível	conceptível, concetível
conceptividade	concetividade
conceptivo	concetivo
conceptual	conceptual, concetual
conceptualismo	conceptualismo, concetualismo
conceptualista	conceptualista, concetualista
conceptualístico	conceptualístico, concetualístico
conceptualização	conceptualização, concetualização
conceptualizar	conceptualizar, concetualizar
conceptualmente	conceptualmente, concetualmente
conchóide	conchoide
concóide	concoide
condilóide	condiloide
condróide	condroide
conectividade	conectividade, conetividade
conectivo	conetivo, conectivo
conector	conector, conetor
confecção	confeção
confeccionador	confecionador
confeccionar	confecionar
confeccionável	confecionável
conjectânea	conjetânea
conjectura	conjetura
conjecturabilidade	conjeturabilidade
conjecturador	conjeturador
conjectural	conjetural
conjecturalmente	conjeturalmente
conjecturante	conjeturante
conjecturar	conjeturar
conjecturável	conjeturável
conjecturista	conjeturista
conóide	conoide
conquilióide	conquilioide
conspecção	conspeção
consumpção	consumpção, consunção
consumptibilidade	consumptibilidade, consuntibilidade
consumptível	consumptível, consuntível
consumptivo	consumptivo, consuntivo
consumptor	consumptor, consuntor
conto-da-carochinha	conto da carochinha
conto-do-vigário	conto do vigário
contra-documento	contradocumento
contra-édito	contraédito
contra-emboscada	contraemboscada
contra-emergentes	contraemergentes
contra-erva	contraerva
contra-escarpa	contraescarpa
contra-escota	contraescota
contra-escritura	contraescritura
contra-espionagem	contraespionagem
contra-estai	contraestai
contra-estais	contraestais
contra-estimulação	contraestimulação
contra-estimulação	contraestimulação
contra-estimulante	contraestimulante
contra-estimular	contraestimular
contra-estimulismo	contraestimulismo
contra-estimulista	contraestimulista
contra-estímulo	contraestímulo
contra-indicação	contraindicação
contra-indicação	contraindicação
contra-indicado	contraindicado
contra-indicar	contraindicar
contra-informação	contrainformação
contra-informar	contrainformar
contra-interpelação	contrainterpelação
contra-interrogatório	contrainterrogatório
contra-natura	contranatura
contra-ofensiva	contraofensiva
contra-oferta	contraoferta
contra-oitava	contraoitava
contra-ordem	contraordem
contra-ordenação	contraordenação
contra-ordenacional	contraordenacional
contra-ordenar	contraordenar
contra-rampa	contrarrampa
contra-rancho	contrarrancho
contra-rapante	contrarrapante
contra-rapantes	contrarrapantes
contra-reacção	contrarreação
contra-regra	contrarregra
contra-regulador	contrarregulador
contra-relógio	contrarrelógio
contra-reparo	contrarreparo
contra-réplica	contrarréplica
contra-repto	contrarrepto
contra-resposta	contrarresposta
contra-retábulo	contrarretábulo
contra-revolta	contrarrevolta
contra-revolução	contrarrevolução
contra-revolucionar	contrarrevolucionar
contra-revolucionária	contrarrevolucionária
contra-revolucionário	contrarrevolucionário
contra-roda	contrarroda
contra-rotura	contrarrotura
contra-ruptura	contrarrutura
contra-safra	contrassafra
contra-seguro	contrasseguro
contra-selar	contrasselar
contra-selo	contrasselo
contra-senha	contrassenha
contra-senso	contrassenso
contra-significação	contrassignificação
contra-sinal	contrassinal
contra-sujeito	contrassujeito
contracção	contração
contracepção	contraceção
contraceptivo	contracetivo
contráctil	contráctil, contrátil
contractilidade	contractilidade, contratilidade
contractível	contractível, contratível
contractivo	contractivo, contrativo
contracto	contracto, contrato
contractura	contractura, contratura
contracturante	contracturante, contraturante
contrafacção	contrafação
contrafactor	contrafator
contraprojecto	contraprojeto
convector	convetor
convolvulóide	convolvuloide
coqueluchóide	coqueluchoide
cor-de-laranja	cor de laranja
cor-de-vinho	cor de vinho
coracóide	coracoide
coralóide	coraloide
corióide	corioide
coróide	coroide
coronóide	coronoide
corpo-a-corpo	corpo a corpo
correcção	correção
correccional	correcional
correccionalmente	correcionalmente
correctamente	corretamente
correctismo	corretismo
correctivamente	corretivamente
correctivo	corretivo
correcto	correto
corrector	corretor
correctora	corretora
correctoria	corretoria
correctório	corretório
correctriz	corretriz
correspectivo	correspetivo
corticóide	corticoide
corticosteróide	corticosteroide
cotilóide	cotiloide
couve-de-sabóia	couve-de-saboia
cova-do-ladrão	cova do ladrão
cranióide	cranioide
cravagem-do-centeio	cravagem do centeio
cretinóide	cretinoide
cricóide	cricoide
crinóide	crinoide
crioceróide	crioceroide
criptozóico	criptozoico
cristaleléctrico	cristalelétrico
cristalóide	cristaloide
criticóide	criticoide
cróia	croia
crotalóide	crotaloide
ctenóide	ctenoide
cubóide	cuboide
cujubibóia	cujubiboia
curral-de-trapiche	curral de trapiche
cururubóia	cururuboia
cutirreacção	cutirreação
dacrióide	dacrioide
dactilar	dactilar, datilar
dactiliográfico	dactiliográfico, datiliográfico
dactiliologia	dactiliologia, datiliologia
dactiliológico	dactiliológico, datiliológico
dactiliólogo	dactiliólogo, datiliólogo
dactiliomântico	dactiliomântico, datiliomântico
dactilofasia	dactilofasia, datilofasia
dactilógrafa	datilógrafa, dactilógrafa
dactilografado	datilografado, dactilografado
dactilografar	datilografar, dactilografar
dactilografia	datilografia, dactilografia
dactilograficamente	dactilograficamente, datilograficamente
dactilográfico	datilográfico, dactilográfico
dactilógrafo	dactilógrafo, datilógrafo
dactilograma	dactilograma, datilograma
dactilóide	dactiloide
dactilólobo	dactilólobo, datilólobo
dactilologia	dactilologia, datilologia
dactilológico	dactilológico, datilológico
dactilomante	dactilomante, datilomante
dactilomântico	dactilomântico, datilomântico
dactilonomia	dactilonomia, datilonomia
dactilóptero	dactilóptero, datilóptero
dactiloscopia	dactiloscopia, datiloscopia
dactiloscópico	dactiloscópico, datiloscópico
dactiloteca	dactiloteca, datiloteca
dactilozoário	dactilozoário, datilozoário
dactilozóide	dactilozoide, datilozoide
dança-de-são-vito	dança de São Vito
deadjectival	deadjetival
decepção	deceção
decepcionado	dececionado
decepcionante	dececionante
decepcionar	dececionar
decepcionável	dececionável
deceptivo	decetivo
defecção	defeção
defectibilidade	defetibilidade
defectível	defetível
defectividade	defetividade
defectivo	defetivo
defectório	defetório
defectuoso	defetuoso
deflectir	defletir, deflectir
deflectível	defletível, deflectível
deflectográfico	defletográfico
deflectógrafo	defletógrafo
deflectométrico	defletométrico
deflectómetro	defletómetro
deflector	defletor, deflector
deíctico	deítico, deíctico
dêictico	dêitico, dêictico
dejecção	dejeção
dejectar	dejetar
dejecto	dejeto
dejectório	dejetório
delfinóide	delfinoide
deltóide	deltoide
demo-liberal	demoliberal
demo-liberalismo	demoliberalismo
dendróide	dendroide
dente-de-coelho	dente de coelho
dentes-de-lobo	dentes de lobo
dentes-de-serra	dentes de serra
dermatóide	dermatoide
dermóide	dermoide
dermoprotector	dermoprotetor
desactivação	desativação
desactivado	desativado
desactivar	desativar
desactualização	desatualização
desactualizado	desatualizado
desactualizar	desatualizar
desafectação	desafetação
desafectadamente	desafetadamente
desafectado	desafetado
desafectar	desafetar
desafecto	desafeto
desarquitectar	desarquitetar
desbaptizar	desbatizar
descaracterização	descaracterização, descaraterização
descaracterizado	descaracterizado, descaraterizado
descaracterizar	descaracterizar, descaraterizar
descontracção	descontração
deselectrizar	deseletrizar
deselectrizável	deseletrizável
desinfecção	desinfeção
desinfeccionar	desinfecionar
desinfectador	desinfetador
desinfectante	desinfetante
desinfectar	desinfetar
desinfectável	desinfetável
desinfectório	desinfetório
desmóide	desmoide
desmorréctico	desmorrético
desprotecção	desproteção
detecção	deteção
detectabilidade	detetabilidade
detectar	detetar
detectável	detetável
detectiva	detetiva
detective	detetive
detector	detetor
detracção	detração
detractivo	detrativo
detractor	detrator
detractora	detratora
Dezembro	dezembro
dia-a-dia	dia a dia
dialectal	dialetal
dialectalmente	dialetalmente
dialéctica	dialética
dialecticamente	dialeticamente
dialéctico	dialético
dialectismo	dialetismo
dialectista	dialetista
dialectização	dialetização
dialectizar	dialetizar
dialecto	dialeto
dialectologia	dialetologia
dialectológico	dialetológico
dialectologista	dialetologista
dialectólogo	dialetólogo
diamantóide	diamantoide
diapnóico	diapnoico
dicataléctico	dicatalético
dicróico	dicroico
didacta	didata
didáctica	didática
didacticamente	didaticamente
didáctico	didático
didactismo	didatismo
didactologia	didactologia, didatologia
didactológico	didactológico, didatológico
dielectricidade	dieletricidade
dieléctrico	dielétrico
difracção	difração
difractar	difratar
difractivo	difrativo
difractómetro	difractómetro, difratómetro
dilecção	dileção
dilecto	dileto
dinamoeléctrico	dinamoelétrico
dióico	dioico
diplóico	diploico
diplóide	diploide
dipnóico	dipnoico
direcção	direção
direcção-geral	direção-geral
direcção-regional	direção-regional
direccionabilidade	direcionabilidade
direccionado	direcionado
direccional	direcional
direccionamento	direcionamento
direccionar	direcionar
direccionável	direcionável
directa	direta
directamente	diretamente
directiva	diretiva
directivo	diretivo
directo	direto
director	diretor
director-adjunto	diretor-adjunto
director-delegado	diretor-delegado
director-desportivo	diretor-desportivo
director-editor	diretor-editor
director-executivo	diretor-executivo
director-geral	diretor-geral
director-proprietário	diretor-proprietário
directora-executiva	diretora-executiva
directora-geral	diretora-geral
directorado	diretorado
directoral	diretoral
directoria	diretoria
directorial	diretorial
directório	diretório
directriz	diretriz
discóide	discoide
disléctico	dislético
disoréctico	disorético
distáctico	distático
distracção	distração
distráctil	distrátil
distractivo	distrativo
dolicóide	dolicoide
ecfráctico	ecfrático
ecléctica	eclética
eclecticamente	ecleticamente
eclecticismo	ecleticismo
ecléctico	eclético
eclectismo	ecletismo
eclíptica	eclíptica, eclítica
eclíptico	eclíptico, eclítico
eco-eficiência	ecoeficiência
eco-taxa	ecotaxa
ecóico	ecoico
edictal	edital
edicto	edito
edrioasteróides	edrioasteroides
efectivação	efetivação
efectivador	efetivador
efectivamente	efetivamente
efectivar	efetivar
efectivável	efetivável
efectível	efetível
efectividade	efetividade
efectivo	efetivo
efectuação	efetuação
efectuador	efetuador
efectuar	efetuar
efectuável	efetuável
efectuoso	efetuoso
efracção	efração
efractura	efratura
ejecção	ejeção
ejectar	ejetar
ejectável	ejetável
ejectólito	ejetólito
ejector	ejetor
electivamente	eletivamente
electividade	eletividade
electivo	eletivo
electracústica	eletracústica
electrão	eletrão
electrão-volt	eletrão-volt
electrargol	eletrargol
electrencefalografia	eletrencefalografia
electrencefalográfico	eletrencefalográfico
electrencefalograma	eletrencefalograma
electrete	eletrete
electrexecução	eletrexecução
electricamente	eletricamente
electricidade	eletricidade
electricismo	eletricismo
electricista	eletricista
eléctrico	elétrico
electrificação	eletrificação
electrificador	eletrificador
electrificar	eletrificar
electrificável	eletrificável
electríman	eletríman
eléctrino	elétrino
electrização	eletrização
electrizador	eletrizador
electrizante	eletrizante
electrizar	eletrizar
electrizável	eletrizável
electroacústico	eletroacústico
electrobalística	eletrobalística
electrobiologia	eletrobiologia
electrobiológico	eletrobiológico
electrobomba	eletrobomba
electrocardiografia	eletrocardiografia
electrocardiográfico	eletrocardiográfico
electrocardiógrafo	eletrocardiógrafo
electrocardiograma	eletrocardiograma
electrochoque	eletrochoque
electrocinética	eletrocinética
electrocinético	eletrocinético
electrocirurgia	eletrocirurgia
electrocoagulação	eletrocoagulação
electrocultura	eletrocultura
electrocussão	eletrocussão
electrocutado	eletrocutado
electrocutar	eletrocutar
electrocutir	eletrocutir
electrocutor	eletrocutor
electrodeposição	eletrodeposição
electrodiagnóstico	eletrodiagnóstico
electrodiálise	eletrodiálise
electrodinâmica	eletrodinâmica
electrodinâmico	eletrodinâmico
electrodinamismo	eletrodinamismo
electrodinamómetro	eletrodinamómetro
electródio	eletródio
eléctrodo	elétrodo
electrodoméstico	eletrodoméstico
electroencefalografia	eletroencefalografia
electroencefalográfico	eletroencefalográfico
electroencefalógrafo	eletroencefalógrafo
electroencefalograma	eletroencefalograma
electrófilo	eletrófilo
electrofisiologia	eletrofisiologia
electrofisiológico	eletrofisiológico
electrofone	eletrofone
electroforese	eletroforese
electroformação	eletroformação
electróforo	eletróforo
electrofotografia	eletrofotografia
electrofotográfico	eletrofotográfico
electrogalvânico	eletrogalvânico
electrogalvanismo	eletrogalvanismo
electrogéneo	eletrogéneo
electrogénese	eletrogénese
electrogenético	eletrogenético
electrógeno	eletrógeno
electrogerador	eletrogerador
electrografia	eletrografia
electrográfico	eletrográfico
electrógrafo	eletrógrafo
electroíman	eletroíman
electrolisação	eletrolisação
electrolisador	eletrolisador
electrolisar	eletrolisar
electrolisável	eletrolisável
electrólise	eletrólise
electrolítico	eletrolítico
electrólito	eletrólito
electrologia	eletrologia
electrológico	eletrológico
electroluminescência	eletroluminescência
electroluminescente	eletroluminescente
electromagnete	eletromagnete
electromagnético	eletromagnético
electromagnetismo	eletromagnetismo
electromecânica	eletromecânica
electromecânico	eletromecânico
electromeopatia	eletromeopatia
electrometalurgia	eletrometalurgia
electrometalúrgico	eletrometalúrgico
electrometria	eletrometria
electrométrico	eletrométrico
electrómetro	eletrómetro
electromiografia	eletromiografia
electromiograma	eletromiograma
electromotor	eletromotor
electromotriz	eletromotriz
electromóvel	eletromóvel
eléctron	elétron
electronegatividade	eletronegatividade
electronegativo	eletronegativo
electrónica	eletrónica
electronicamente	eletronicamente
electrónico	eletrónico
electrónio	eletrónio
electroóptica	eletro-ótica
electroóptico	eletro-ótico
electropexia	eletropexia
electropositividade	eletropositividade
electropositivo	eletropositivo
electróptica	eletrótica
electropunctura	eletropuntura, eletropunctura
electroquímica	eletroquímica
electroquímico	eletroquímico
electrorradiologia	eletrorradiologia
electrorradiologista	eletrorradiologista
electroscopia	eletroscopia
electroscópico	eletroscópico
electroscópio	eletroscópio
electrossemáforo	eletrossemáforo
electrosserra	eletrosserra
electrossiderurgia	eletrossiderurgia
electrossiderúrgico	eletrossiderúrgico
electrossoldadura	eletrossoldadura
electrostática	eletrostática
electrostático	eletrostático
electrostricção	eletrostrição
electrotanásia	eletrotanásia
electrotecnia	eletrotecnia
electrotécnica	eletrotécnica
electrotécnico	eletrotécnico
electroterapeuta	eletroterapeuta
electroterapêutica	eletroterapêutica
electroterapêutico	eletroterapêutico
electroterapia	eletroterapia
electroterápico	eletroterápico
electrotermia	eletrotermia
electrotérmico	eletrotérmico
electrotipia	eletrotipia
electrotípico	eletrotípico
electrótipo	eletrótipo
electrotónico	eletrotónico
electrotropia	eletrotropia
electrotrópico	eletrotrópico
electrotropismo	eletrotropismo
electrovalência	eletrovalência
electrovalente	eletrovalente
electrovegetómetro	eletrovegetómetro
electrovital	eletrovital
electrovitalismo	eletrovitalismo
electrozónio	eletrozónio
elefantóide	elefantoide
elipsóide	elipsoide
elitróide	elitroide
embrióide	embrioide
encefalóide	encefaloide
enguia-eléctrica	enguia-elétrica
enterozóico	enterozoico
entreacto	entreato
enzóico	enzoico
Eozóico	Eozoico
epiciclóide	epicicloide
epidermóide	epidermoide
epiléptica	epilética
epiléptico	epilético
epileptóide	epileptoide
epiplóico	epiploico
epitelióide	epitelioide
epizóico	epizoico
equinóide	equinoide
Equinóides	Equinoides
equióide	equioide
erecção	ereção
erectamente	eretamente
erectida	eretida
eréctil	eréctil, erétil
erectilidade	erectilidade, eretilidade
erecto	ereto
erector	eretor
eritemóide	eritemoide
eritróide	eritroide
escafóide	escafoide
escarlatinóide	escarlatinoide
escorpióide	escorpioide
esfenóide	esfenoide
esferóide	esferoide
esméctico	esmético
espectacular	espetacular
espectacularidade	espetacularidade
espectacularmente	espetacularmente
espectáculo	espetáculo
espectaculosamente	espetaculosamente
espectaculosidade	espetaculosidade
espectaculoso	espetaculoso
espectador	espectador, espetador
espectadora	espectadora, espetadora
espectral	espectral, espetral
espectralidade	espectralidade, espetralidade
espectro	espectro, espetro
espectrofobia	espectrofobia, espetrofobia
espectrofotometria	espectrofotometria, espetrofotometria
espectrofotométrico	espectrofotométrico, espetrofotométrico
espectrofotómetro	espectrofotómetro, espetrofotómetro
espectrografia	espectrografia, espetrografia
espectrográfico	espectrográfico, espetrográfico
espectrógrafo	espectrógrafo, espetrógrafo
espectrograma	espectrograma, espetrograma
espectrologia	espectrologia, espetrologia
espectrológico	espectrológico, espetrológico
espectrometria	espectrometria, espetrometria
espectrométrico	espectrométrico, espetrométrico
espectrómetro	espectrómetro, espetrómetro
espectroscopia	espectroscopia, espetroscopia
espectroscópico	espectroscópico, espetroscópico
espectroscópio	espectroscópio, espetroscópio
espectroscopista	espetroscopista, espectroscopista
espermatozóide	espermatozoide
espiróide	espiroide
esplenenfráctico	esplenenfrático
esplenóide	esplenoide
esplenopéctico	esplenopético
espongióide	espongioide
espuma-do-mar	espuma do mar
esquistóide	esquistoide
esquizóide	esquizoide
estaminóide	estaminoide
estatorreactor	estatorreator
esteleróide	esteleroide
esteróide	esteroide
estilóide	estiloide
Estio	estio
estóica	estoica
estóico	estoico
estrongilóide	estrongiloide
estupefacção	estupefação
estupefactivo	estupefactivo, estupefativo
estupefactor	estupefator
etanodióico	etanodioico
etanóico	etanoico
etmóide	etmoide
eubóico	euboico
eunucóide	eunucoide
euplóide	euploide
eurocéptica	eurocética
eurocepticismo	euroceticismo
eurocéptico	eurocético
europtimismo	eurotimismo
eutáctico	eutático
ex-accionista	ex-acionista
ex-director	ex-diretor
ex-directora	ex-diretora
ex-seleccionador	ex-selecionador
exacção	exação
exactamente	exatamente
exactidão	exatidão
exactificar	exatificar
exactissimamente	exatissimamente
exactíssimo	exatíssimo
exacto	exato
exactor	exator
exactoria	exatoria
excepção	exceção
excepcional	excecional
excepcionalidade	excecionalidade
excepcionalmente	excecionalmente
excepcionar	excecionar
excepta	exceta
exceptivo	excetivo
excepto	exceto
exceptuador	excetuador
exceptuar	excetuar
exceptuável	excetuável
expectação	expectação, expetação
expectador	expectador, expetador
expectadora	expectadora, expetadora
expectante	expectante, expetante
expectantismo	expectantismo, expetantismo
expectar	expectar, expetar
expectativa	expectativa, expetativa
expectatório	expectatório, expetatório
expectável	expectável, expetável
expectoração	expetoração
expectorante	expetorante
expectorar	expetorar
exteroceptivo	exterocetivo
exteroceptor	exterocetor
extra-escolar	extraescolar
extra-estatutário	extraestatutário
extra-europeu	extraeuropeu
extra-ocular	extraocular
extra-oficial	extraoficial
extra-oficialmente	extraoficialmente
extra-orgânico	extraorgânico
extra-regimental	extrarregimental
extra-regulamentar	extrarregulamentar
extra-secular	extrassecular
extra-sensível	extrassensível
extra-sensorial	extrassensorial
extra-sensorialidade	extrassensorialidade
extra-sístole	extrassístole
extra-sistólico	extrassistólico
extra-urbano	extraurbano
extra-uterino	extrauterino
extracção	extração
extractar	extratar
extractiforme	extratiforme
extractivo	extrativo
extracto	extrato
extractor	extrator
extractora	extratora
extrojecção	extrojeção
extrospecção	extrospeção
extrospectivo	extrospetivo
faca-de-mato	faca de mato
facção	fação
facóide	facoide
factóide	factoide
factor	fator
factor-chave	fator-chave
factorial	fatorial
factorizar	fatorizar
factura	fatura
facturação	faturação
facturar	faturar
facturável	faturável
falóide	faloide
Fanerozóico	Fanerozoico
farinha-de-pau	farinha de pau
fascistóide	fascistoide
fato-de-banho	fato de banho
fato-de-macaco	fato de macaco
fato-de-saia-e-casaco	fato de saia e casaco
fato-de-treino	fato de treino
fava-do-egipto	fava-do-egito
febre-de-malta	febre de Malta
febre-dos-fenos	febre dos fenos
febre-dos-três-dias	febre dos três dias
fecalóide	fecaloide
feculóide	feculoide
feldspatóide	feldspatoide
ferrielectricidade	ferrieletricidade
ferrieléctrico	ferrielétrico
ferro-de-engomar	ferro de engomar
ferro-de-romã	ferro de romã
ferroelectricidade	ferroeletricidade
ferroeléctrico	ferroelétrico
Fevereiro	fevereiro
fezes-de-ouro	fezes de ouro
fibróide	fibroide
ficóide	ficoide
filho-da-terra	filho da terra
filho-de-parida	filho de parida
filocacto	filocato
filóide	filoide
filotáctico	filotático
fim-de-semana	fim de semana
fimatóide	fimatoide
fio-de-prumo	fio de prumo
fios-de-ovos	fios de ovos
fiscal-de-linha	fiscal de linha
fisóide	fisoide
fitóide	fitoide
fitotáctico	fitotático
flavonóide	flavonoide
flebopéctico	flebopético
flectido	fletido
flectir	fletir
flectómetro	fletómetro
flector	fletor
flictena	flitena
flictenóide	flictenoide
flor-de-enxofre	flor de enxofre
focinho-de-tenca	focinho de tenca
fogo-de-artifício	fogo de artifício
fogo-de-bengala	fogo de Bengala
fogo-de-santelmo	fogo de Santelmo
fogo-de-santo-antão	fogo de Santo Antão
fogo-de-vista	fogo de vista
fogo-do-ar	fogo do ar
fóia	foia
fóide	foide
fóio	foio
folha-de-flandres	folha de Flandres
folhos-de-sinhá	folhos de sinhá
fonético-sintacticamente	fonético-sintaticamente
fonético-sintáctico	fonético-sintático
fora-da-lei	fora da lei
fora-de-jogo	fora de jogo
fotelectrão	foteletrão
fotelectricidade	foteletricidade
foteléctrico	fotelétrico
foto-receptor	fotorrecetor
fotodieléctrico	fotodielétrico
fotoelectrão	fotoeletrão
fotoelectricidade	fotoeletricidade
fotoeléctrico	fotoelétrico
fotóptico	fotótico
fototáctico	fototático
fototactismo	fototactismo, fototatismo
fracção	fração
fraccionamento	fracionamento
fraccionar	fracionar
fraccionário	fracionário
fraccionável	fracionável
fracciúncula	fraciúncula
fractura	fratura
fracturamento	fraturamento
fracturante	fraturante
fracturar	fraturar
fracturável	fraturável
fradinho-da-mão-furada	fradinho da mão furada
fradinho-de-mão-furada	fradinho de mão furada
frente-a-frente	frente a frente
frutos-do-mar	frutos do mar
fucóide	fucoide
fula-de-gabu	fula de Gabu
Fulano	fulano
funarióide	funarioide
furcróia	furcroia
fusóide	fusoide
gabróico	gabroico
gadóide	gadoide
gaita-de-beiços	gaita de beiços
gaita-de-foles	gaita de foles
galactóide	galactoide
galinsecto	galinseto
galvanopunctura	galvanopuntura, galvanopunctura
galvanotáctico	galvanotático
gamozóide	gamozoide
ganóide	ganoide
gás-dos-pântanos	gás dos pântanos
gaspóia	gaspoia
gastrepiplóico	gastrepiploico
gastroepiplóico	gastroepiploico
gastropéctico	gastropético
gastrozóide	gastrozoide
genuflectir	genufletir
genuflector	genufletor
genuflectora	genufletora
geóide	geoide
geotáctico	geotático
gesso-de-paris	gesso de Paris
glenóide	glenoide
glossóide	glossoide
glucocorticóide	glucocorticoide
gogóia	gogoia
gonozóide	gonozoide
grafióide	grafioide
granitóide	granitoide
grapsóide	grapsoide
grecóide	grecoide
gróia	groia
grosso-de-nápoles	grosso de Nápoles
grupóide	grupoide
guarda-de-corpo	guarda de corpo
guarda-jóias	guarda-joias
guarda-nocturno	guarda-noturno
halóide	haloide
haplóide	haploide
haptotáctico	haptotático
haptotactismo	haptotactismo, haptotatismo
helicóide	helicoide
heliotactismo	heliotatismo
helmintóide	helmintoide
hematóide	hematoide
hematosséptico	hematossético
hemiatáctico	hemiatático
hemisferóide	hemisferoide
hemóide	hemoide
hemoptóico	hemoptoico
hemorróida	hemorroida
hemorróide	hemorroide
hemorróides	hemorroides
hemotéctico	hemotético
hepatopéctico	hepatopético
heróico	heroico
heróide	heroide
hetero-avaliação	heteroavaliação
heteróide	heteroide
heteroinfecção	heteroinfeção
heterorréctico	heterorrético
heterosséptico	heterossético
heterotáctico	heterotático
hialóide	hialoide
hidatóide	hidatoide
hidreléctrico	hidrelétrico
hidroeléctrica	hidroelétrica
hidroelectricidade	hidroeletricidade
hidroeléctrico	hidroelétrico
hidroextractor	hidroextrator
hidrofráctico	hidrofrático
hidróide	hidroide
hidrotactismo	hidrotactismo, hidrotatismo
hilozóico	hilozoico
himenóide	himenoide
hióide	hioide
hiperactividade	hiperatividade
hiperactivo	hiperativo
hiperbolóide	hiperboloide
hipercataléctico	hipercatalético
hipercatalecto	hipercataleto
hipercorrecção	hipercorreção
hipercorrecto	hipercorreto
hiperdialéctico	hiperdialético
hipereutéctico	hipereutético
hipeutéctico	hipeutético
hipnóide	hipnoide
hipociclóide	hipocicloide
hipotáctico	hipotático
hipozóico	hipozoico
histeropéctico	histeropético
holantárctico	holantártico
holárctico	holárctico
holoturióide	holoturioide
holozóico	holozoico
homalóide	homaloide
homeocataléctico	homeocatalético
homeocatalecto	homeocataleto
homeozóico	homeozoico
homóide	homoide
humanóide	humanoide
ictérica	ictérica, itérica
icterícia	icterícia, iterícia
ictérico	ictérico, itérico
icteróide	icteroide
ictióide	ictioide
idielectricidade	idieletricidade
idieléctrico	idielétrico
idioeléctrico	idioelétrico
idiolecto	idioleto
ignipunctura	ignipuntura, ignipunctura
imperceptibilidade	impercetibilidade
imperceptível	impercetível
imperceptivelmente	impercetivelmente
imperfectibilidade	imperfetibilidade, imperfectibilidade
imperfectível	imperfetível, imperfectível
imperfectivelmente	imperfetivelmente, imperfectivelmente
imperfectividade	imperfetividade, imperfectividade
imperfectivo	imperfetivo, imperfectivo
imputrefacção	imputrefação
imunoelectroforese	imunoeletroforese
imunorreacção	imunorreação
imunorreactivo	imunorreativo
inacção	inação
inactiva	inativa
inactivação	inativação
inactivamente	inativamente
inactivar	inativar
inactividade	inatividade
inactivo	inativo
inactual	inatual
inadoptável	inadotável
inafectivo	inafetivo
incaracteristicamente	incaracteristicamente, incarateristicamente
incaracterístico	incaracterístico, incaraterístico
incaracterizado	incaracterizado, incaraterizado
incaracterizável	incaracterizável, incaraterizável
inconsumptibilidade	inconsumptibilidade, inconsuntibilidade
incorrecção	incorreção
incorrectamente	incorretamente
incorrecto	incorreto
indefectibilidade	indefetibilidade
indefectível	indefetível
indefectivelmente	indefetivelmente
indetectável	indetetável
indirecta	indireta
indirectamente	indiretamente
indirecto	indireto
inefectivo	inefetivo
inexacção	inexação
inexactamente	inexatamente
inexactidão	inexatidão
inexacto	inexato
infanto-juvenil	infantojuvenil
infecção	infeção
infecciologia	infeciologia
infecciologista	infeciologista
infeccionado	infecionado
infeccionar	infecionar
infeccioso	infecioso
infectada	infetada
infectado	infetado
infectante	infetante
infectar	infetar
infectável	infetável
infecto	infeto, infecto
infecto-contagioso	infetocontagioso, infectocontagioso
infectologia	infetologia
infectológico	infetológico
infectuosidade	infetuosidade
inflectir	infletir
inflicção	inflição
info-alfabetização	infoalfabetização
info-excluído	infoexcluído
info-exclusão	infoexclusão
infra-escapular	infraescapular
infra-escavação	infraescavação
infra-escrito	infraescrito
infra-estrutura	infraestrutura
infra-estruturação	infraestruturação
infra-estruturado	infraestruturado
infra-estrutural	infraestrutural
infra-oitava	infraoitava
infra-orbitário	infraorbitário
infra-renal	infrarrenal
infra-som	infrassom
infracção	infração
infractor	infrator
infractora	infratora
injecção	injeção
injectado	injetado
injectador	injetador
injectar	injetar
injectável	injetável
injectiva	injetiva
injectivo	injetivo
injecto	injeto
injector	injetor
inobjectável	inobjetável
inobjectividade	inobjetividade
inopéctico	inopético
insecticida	inseticida
insecticídio	inseticídio
insectífero	insectífero, insetífero
insectiforme	insectiforme, insetiforme
insectívoro	insetívoro, insectívoro
insecto	inseto
insectófilo	insectófilo, insetófilo
insectologia	insectologia, insetologia
insectológico	insectológico, insetológico
insectologista	insetologista, insectologista
inspecção	inspeção
inspecção-geral	inspeção-geral
inspeccionador	inspecionador
inspeccionamento	inspecionamento
inspeccionar	inspecionar
inspeccionável	inspecionável
inspectar	inspetar
inspectivo	inspetivo
inspector	inspetor
inspector-adjunto	inspetor-adjunto
inspector-geral	inspetor-geral
inspector-orientador	inspetor-orientador
inspectora	inspetora
inspectora-geral	inspetora-geral
inspectorado	inspetorado
inspectoria	inspetoria
inspectório	inspetório
insurreccionado	insurrecionado
insurreccional	insurrecional
insurreccionalmente	insurrecionalmente
insurreccionar	insurrecionar
insurreccionário	insurrecionário
insurreccionável	insurrecionável
insurreccionismo	insurrecionismo
insurreccionista	insurreccionista
insurrecta	insurreta
insurrecto	insurreto
insusceptível	insuscetível
intáctil	intáctil, intátil
intactilidade	intactilidade, intatilidade
intelecção	inteleção, intelecção
interacção	interação
interaccionismo	interacionismo
interactividade	interatividade
interactivo	interativo
interactuar	interatuar
intercepção	interceção
interceptação	intercetação
interceptado	intercetado
interceptador	intercetador
interceptadora	intercetadora
interceptante	intercetante
interceptar	intercetar
interceptável	intercetável
interceptivo	intercetivo
intercepto	intercepto, interceto
interceptor	intercetor
interceptora	intercetora
interceptório	intercetório
interjeccional	interjecional
interjeccionar	interjecionar
interjectivamente	interjetivamente
interjectivo	interjetivo
interruptor	interruptor, interrutor
interruptora	interruptora, interrutora
intersecção	interseção, intersecção
interseccional	intersecional, interseccional
interseccionismo	intersecionismo, interseccionismo
intersectar	intersetar, intersectar
intersubjectividade	intersubjetividade
intersubjectivo	intersubjetivo
intra-específico	intraespecífico
intra-ocular	intraocular
intra-orgânico	intraorgânico
intra-ósseo	intraósseo
intra-raquidiano	intrarraquidiano
intra-secular	intrassecular
intra-sinovial	intrassinovial
intra-uterino	intrauterino
intróito	introito
introjecção	introjeção
introspecção	introspeção
introspeccionista	introspecionista
introspectivamente	introspetivamente
introspectivo	introspetivo
intuscepção	intusceção
intuspecção	intuspeção
intuspectivamente	intuspetivamente
intuspectivo	intuspetivo
intussuscepção	intussusceção
inumectação	inumetação
invectiva	invetiva
invectivador	invetivador
invectivante	invetivante
invectivar	invetivar
invectivista	invetivista
invectivo	invetivo
Inverno	inverno
ipsilóide	ipsiloide
iridorréctico	iridorrético
irreflectidamente	irrefletidamente
irreflectido	irrefletido
irretractável	irretratável
irretractavelmente	irretratavelmente
irretroactividade	irretroatividade
irretroactivo	irretroativo
iseléctrico	iselétrico
isocolóide	isocoloide
isoeléctrico	isoelétrico
isoelectrónico	isoeletrónico
jabutibóia	jabutiboia
jacto	jato
jactoplanador	jatoplanador
Janeiro	janeiro
jaquiranabóia	jaquiranaboia
jardim-de-infância	jardim de infância
jaspóide	jaspoide
jequitiranabóia	jequitiranaboia
jibóia	jiboia
jitiranabóia	jitiranaboia
jóia	joia
jóina	joina
juiz-de-campo	juiz de campo
juiz-de-linha	juiz de linha
Julho	julho
Junho	junho
juruparibóia	jurupariboia
láctico	láctico, lático
lambdóide	lambdoide
lambisgóia	lambisgoia
leccionação	lecionação
leccionador	lecionador
leccionando	lecionando
leccionar	lecionar
leccionário	lecionário
leccionável	lecionável
leccionista	lecionista
lectivo	letivo
leite-de-cal	leite de cal
lepidóide	lepidoide
lepóide	lepoide
limpa-pára-brisa	limpa-para-brisa
limpa-pára-brisas	limpa-para-brisas
linfóide	linfoide
língua-de-gato	língua de gato
língua-de-sogra	língua de sogra
língua-de-trapos	língua de trapos
língua-de-veado	língua de veado
línguas-de-gato	línguas de gato
linha-de-água	linha de água
lipóide	lipoide
liquefacção	liquefação
liquefactivo	liquefativo, liquefactivo
liquefactor	liquefator
liquenóide	liquenoide
lirióide	lirioide
litóide	litoide
lóio	loio
lóio-de-jardim	loio-de-jardim
lóio-do-jardim	loio-do-jardim
lombricóide	lombricoide
lua-de-mel	lua de mel
lumbricóide	lumbricoide
mabóia	maboia
maçã-de-adão	maçã de Adão
macozóide	macozoide
macro-jê	macrojê
macro-tupi	macrotupi
macropinacóide	macropinacoide
madefacção	madefação
mãe-de-aluguer	mãe de aluguer
mãe-de-santo	mãe de santo
magneteléctrico	magnetelétrico
magnetóide	magnetoide
Maio	maio
maláctico	malático
manga-de-alpaca	manga de alpaca
manga-de-eixo	manga de eixo
manufactor	manufator
manufactora	manufatora
manufactura	manufatura
manufacturação	manufaturação
manufacturado	manufaturado
manufacturador	manufaturador
manufacturar	manufaturar
manufacturável	manufaturável
manufactureiro	manufatureiro
mão-de-barca	mão de barca
mão-de-judas	mão de Judas
mão-de-obra	mão de obra
maquinofactura	maquinofatura
marca-de-judas	marca de Judas
Março	março
marco-de-colónia	marco de Colónia
maria-da-fonte	maria da fonte
maria-das-pernas-compridas	maria das pernas compridas
marido-de-bolas	marido de bolas
marmita-de-gigante	marmita de gigante
mastóide	mastoide
meadinha-de-ouro	meadinha de ouro
medusóide	medusoide
megaprojecto	megaprojeto
meia-de-leite	meia de leite
melocacto	melocato
menina-de-cinco-olhos	menina de cinco olhos
menina-do-olho	menina do olho
meningocóccico	meningocócico
meniscóide	meniscoide
merozóito	merozoito
mesa-de-cabeceira	mesa de cabeceira
mesinha-de-cabeceira	mesinha de cabeceira
mesorrecto	mesorreto
Mesozóico	Mesozoico
mestre-de-armas	mestre de armas
mestre-de-cerimónias	mestre de cerimónias
mestre-de-obras	mestre de obras
metaléptico	metalético
metalóide	metaloide
metamorfóptico	metamorfótico
metanóia	metanoia
metapéctico	metapético
metapectina	metapetina
metazóico	metazoico
meteoróide	meteoroide
metrorréctico	metrorrético
micetóide	micetoide
microbjectiva	microbjetiva
microelectrónica	microeletrónica
microondas	micro-ondas
microorganismo	micro-organismo
mielóide	mieloide
mineralóide	mineraloide
mini-autocarro	miniautocarro
mini-saia	minissaia
mini-série	minissérie
mini-submarino	minissubmarino
mini-vestido	minivestido
minóico	minoico
mióide	mioide
miopráctico	mioprático
mirtóide	mirtoide
mixóide	mixoide
moço-de-forcado	moço de forcado
móia	moia
molibdóide	molibdoide
molóide	moloide
moluscóide	moluscoide
mongolóide	mongoloide
monóico	monoico
monóide	monoide
monozóico	monozoico
monte-de-vénus	monte de Vénus
mórfico-sintáctico	mórfico-sintático
morfossintáctico	morfossintático
morte-em-pé	morte em pé
moscas-de-milão	moscas de Milão
moto-serra	motosserra
mucóide	mucoide
muirajibóia	muirajiboia
mulher-a-dias	mulher a dias
multidireccional	multidirecional
multifactorial	multifatorial
multinfecção	multinfeção
multissectorial	multissetorial, multissectorial
muscóide	muscoide
narcisóide	narcisoide
narcoléptico	narcoléptico, narcolético
nariz-de-cera	nariz de cera
nautilóide	nautiloide
nectozóide	nectozoide
nefelóide	nefeloide
nefróide	nefroide
nefropéctico	nefropético
negro-de-fumo	negro de fumo
negróide	negroide
nematóide	nematoide
neo-árico	neoárico
neo-ático	neoático
neo-escolástica	neoescolástica
neo-escolástico	neoescolástico
neo-eslavismo	neoeslavismo
neo-estoicismo	neoestoicismo
neo-estóico	neoestoico
neo-expressionista	neoexpressionista
neo-idealismo	neoidealismo
neo-impressionismo	neoimpressionismo
neo-impressionista	neoimpressionista
neo-realismo	neorrealismo
neo-realista	neorrealista
neo-republicanismo	neorrepublicanismo
neo-republicano	neorepublicano
neo-romântica	neorromântica
neo-romântico	neorromântico
neo-romantismo	neorromantismo
neo-socialismo	neossocialismo
Neozóico	Neozoico
ninfóide	ninfoide
nó-de-adão	nó de Adão
noctívaga	noctívaga, notívaga
noctívago	notívago, noctívago
nocturnal	noturnal
nocturnamente	noturnamente
nocturno	noturno
nocturnos	noturnos
nóia	noia
Novembro	novembro
nucleóide	nucleoide
obducto	obduto
objecção	objeção
objectado	objetado
objectal	objetal
objectante	objetante
objectar	objetar
objectável	objetável
objectiva	objetiva
objectivação	objetivação
objectivado	objetivado
objectivador	objetivador
objectivamente	objetivamente
objectivar	objetivar
objectivável	objetivável
objectividade	objetividade
objectivismo	objetivismo
objectivista	objetivista
objectivo	objetivo
objecto	objeto
objectologia	objetologia
objectológico	objetológico
objectologista	objetologista
objectólogo	objetólogo
objector	objetor
objectora	objetora
obovóide	obovoide
obstupefacção	obstupefação
oco-do-coração	oco do coração
octávia	otávia
odontóide	odontoide
oficial-às-ordens	oficial às ordens
ofióide	ofioide
oitavos-de-final	oitavos de final
olfacção	olfação
olfactar	olfatar
olfáctica	olfática
olfáctico	olfático
olfactivamente	olfativamente
olfactivo	olfativo
olfacto	olfato
olfactometria	olfatometria
olfactométrico	olfatométrico
olfactómetro	olfatómetro
olfactório	olfatório
olho-de-mosquito	olho de mosquito
olho-de-sogra	olho de sogra
olho-de-tigre	olho de tigre
omnidireccional	omnidirecional
omóide	omoide
óptica	ótica
opticidade	opticidade, oticidade
opticista	oticista
óptico	ótico
opticometria	opticometria, oticometria
opticométrico	opticométrico, oticométrico
opticómetro	opticómetro, oticómetro
optimamente	otimamente
optimismo	otimismo
optimista	otimista
optimístico	otimístico
optimização	otimização
optimizar	otimizar
óptimo	ótimo
orelhas-de-abade	orelhas de abade
organóide	organoide
organoléptico	organolético
organotáctico	organotático
orizóide	orizoide
ornitóide	ornitoide
orquiopéctico	orquiopético
ortopinacóide	ortopinacoide
ortopnóico	ortopnoico
osteoganóide	osteoganoide
osteóide	osteoide
Outono	outono
Outubro	outubro
ovóide	ovoide
pai-de-meninos	pai de meninos
pai-de-santo	pai de santo
pai-de-todos	pai de todos
pai-de-velhacos	pai de velhacos
paleárctica	paleártica
paleárctico	paleártico
paleozóico	paleozoico
palha-de-abade	palha de abade
palóio	paloio
palpos-de-aranha	palpos de aranha
panóptico	panótico
pão-de-açúcar	pão de açúcar
pão-de-ló	pão de ló
pão-por-Deus	pão por Deus
papo-de-anjo	papo de anjo
papo-de-rola	papo de rola
pára-água	para-água
pára-águas	para-águas
pára-brisa	para-brisa
pára-brisas	para-brisas
pára-choque	para-choque
pára-choques	para-choques
pára-chuva	para-chuva
para-escolar	paraescolar
pára-fogo	para-fogo
pára-lama	para-lama
pára-lamas	para-lamas
pára-luz	para-luz
pára-quedas	para-quedas
pára-quedismo	para-quedismo
pára-quedista	para-quedista
pára-raios	para-raios
pára-sol	para-sol
pára-vento	para-vento
parabolóide	paraboloide
paraeléctrico	paraelétrico
paralacticamente	paralaticamente
paraláctico	paralático
paraléctico	paralético
paranóia	paranoia
paranóica	paranoica
paranóico	paranoico
paranóide	paranoide
parapéctico	parapético
parapléctico	paraplético
parapopléctico	parapoplético
parasitóide	parasitoide
paratáctico	paratático
paratifóide	paratifoide
paratireóide	paratireoide
paratiróide	paratiroide
pareléctrico	parelétrico
paróptico	parótico
parvóide	parvoide
passarinho-a-olhar	passarinho a olhar
passarinho-do-egipto	passarinho-do-egito
patetóide	patetoide
pau-a-pique	pau a pique
pau-de-cabeleira	pau de cabeleira
pau-de-fileira	pau de fileira
pau-do-ar	pau do ar
paz-de-alma	paz de alma
pé-de-alferes	pé de alferes
pé-de-altar	pé de altar
pé-de-amigo	pé de amigo
pé-de-atleta	pé de atleta
pé-de-banco	pé de banco
pé-de-boi	pé de boi
pé-de-cabra	pé de cabra
pé-de-cana	pé de cana
pé-de-candeeiro	pé de candeeiro
pé-de-cantiga	pé de cantiga
pé-de-cavalo	pé de cavalo
pé-de-chumbo	pé de chumbo
pé-de-dança	pé de dança
pé-de-moleque	pé de moleque
pé-de-pato	pé de pato
pé-de-vento	pé de vento
pedaço-de-asno	pedaço de asno
pedra-da-lua	pedra da lua
pedra-das-amazonas	pedra das amazonas
pedra-de-afiar	pedra de afiar
pedra-de-águia	pedra de águia
pedra-de-amolar	pedra de amolar
pedra-de-cevar	pedra de cevar
pedra-de-raio	pedra de raio
pedra-de-sangue	pedra de sangue
pedra-de-toque	pedra de toque
pedra-do-ar	pedra do ar
pedra-do-sol	pedra do sol
pedrinha-na-boca	pedrinha na boca
pegamóide	pegamoide
pegmatitóide	pegmatitoide
pegmatóide	pegmatoide
peito-de-canga	peito de canga
peito-de-morte	peito de morte
peixe-eléctrico	peixe-elétrico
péla	pela
pele-de-vinho	pele de vinho
pêlo	pelo
penatissecto	penatisseto
penfigóide	penfigoide
péra	pera
pêra	pera
pêra-da-terra	pera-da-terra
pêra-de-arrátel	pera-de-arrátel
pêra-de-bom-cristão	pera-de-bom-cristão
percepção	perceção
percepcionar	percecionar
percepcionismo	percecionismo
percepcionista	percecionista
perceptibilidade	percetibilidade
perceptivamente	percetivamente
perceptível	percetível
perceptivelmente	percetivelmente
perceptividade	percetividade
perceptivo	percetivo
percepto	perceto, percepto
perceptual	percetual
percóide	percoide
perempção	perenção
perempto	perento
peremptoriamente	perentoriamente
peremptoriedade	perentoriedade
peremptório	perentório
perfeccional	perfecional, perfeccional
perfeccionismo	perfecionismo, perfeccionismo
perfeccionista	perfecionista, perfeccionista
perfeccionístico	perfecionístico, perfeccionístico
perfectibilidade	perfetibilidade, perfetibilidade
perfectibilismo	perfetibilismo, perfectibilismo
perfectibilista	perfetibilista, perfectibilista
perfectibilizar	perfetibilizar, perfectibilizar
perfectivação	perfetivação, perfectivação
perfectível	perfetível, perfectível
perfectividade	perfetividade, perfectividade
perfectivo	perfetivo, perfectivo
pergamóide	pergamoide
perirrectite	perirretite
perna-de-serra	perna de serra
pêro	pero
perspéctico	perspético
perspectiva	perspetiva
perspectivação	perspetivação
perspectival	perspetival
perspectivar	perspetivar
perspectividade	perspetividade
perspectivismo	perspetivismo
perspectivista	perspetivista
perspectivístico	perspetivístico
perspectivo	perspetivo
perspectográfico	perspetográfico
perspectógrafo	perspetógrafo
pés-de-lebre	pés de lebre
petalóide	petaloide
pezizóide	pezizoide
piano-dos-pretos	piano dos pretos
pião-das-nicas	pião das nicas
piezelectricidade	piezeletricidade
piezeléctrico	piezelétrico
piezoelectricidade	piezoeletricidade
piezoeléctrico	piezoelétrico
pilóia	piloia
pinacóide	pinacoide
pingo-de-tocha	pingo de tocha
pingos-de-ovos	pingos de ovos
pinho-de-flandres	pinho de Flandres
pinóia	pinoia
pinóio	pinoio
piolho-de-cobra	piolho de cobra
pirelectricidade	pireletricidade
pireléctrico	pirelétrico
pirenóide	pirenoide
piritóide	piritoide
piroelectricidade	piroeletricidade
piroeléctrico	piroelétrico
piróide	piroide
pitecantropóide	pitecantropoide
pitecóide	pitecoide
pitimbóia	pitimboia
placóide	placoide
planetóide	planetoide
plasmorréctico	plasmorrético
platinóide	platinoide
pleocróico	pleocroico
pluriactividade	pluriatividade
pneumopéctico	pneumopético
pneumopléctico	pneumoplético
pó-de-arroz	pó de arroz
pó-de-chipre	pó de Chipre
pó-de-goa	pó de goa
pó-de-sapato	pó de sapato
pó-de-talco	pó de talco
polaróide	polaroide
policróico	policroico
poliplectro	polipletro
poliplóide	poliploide
polipnóico	polipnoico
polipóide	polipoide
politicóide	politicoide
polizóico	polizoico
pomo-de-adão	pomo de Adão
ponta-de-lança	ponta de lança
pôr-do-sol	pôr do sol
porfiróide	porfiroide
porta-da-rua	porta da rua
porta-jóias	porta-joias
porta-objecto	porta-objeto
pós-adjectival	pós-adjetival
pré-adjectival	pré-adjetival
pré-adopção	pré-adoção
pré-objectal	pré-objetal
pré-selecção	pré-seleção
pré-seleccionado	pré-selecionado
pré-selectivo	pré-seletivo
preceptista	precetista, preceptista
preceptivamente	preceptivamente, precetivamente
preceptivo	preceptivo, precetivo
preceptor	precetor, preceptor
preceptora	precetora, preceptora
preceptorado	precetorado, preceptorado
preceptoral	precetoral, preceptoral
preceptoria	precetoria, preceptoria
preceptorial	precetorial, preceptorial
preconcepção	preconceção
preconceptivo	preconcetivo
predilecção	predileção
predilecta	predileta
predilectamente	prediletamente
predilecto	predileto
prelecção	preleção
preleccionador	prelecionador
preleccionar	prelecionar
preleccionista	prelecionista
prelector	preletor
prelectorado	preletorado
Primavera	primavera
príncipe-de-gales	príncipe de Gales
prismatóide	prismatoide
prismóide	prismoide
pró-activo	pró-ativo
procataléptico	procatalético
proctopéctico	proctopético
profilacticamente	profilaticamente
profiláctico	profilático
profilactismo	profilatismo
projecção	projeção
projeccional	projecional
projeccionista	projecionista
projectação	projetação
projectado	projetado
projectador	projetador
projectante	projetante
projectar	projetar
projectável	projetável
projectício	projetício
projéctil	projétil
projectista	projetista
projectivo	projetivo
projecto	projeto
projecto-lei	projeto-lei
projecto-piloto	projeto-piloto
projectográfico	projetográfico
projectógrafo	projetógrafo
projector	projetor
projectoscópico	projetoscópico
projectura	projetura
proléctico	prolético
prolepticamente	proleticamente
propanóico	propanoico
propenóico	propenoico
proprioceptivo	propriocetivo
proprioceptor	propriocetor
prospecção	prospeção
prospectar	prospetar
prospectiva	prospetiva
prospectivo	prospetivo
prospecto	prospeto
prospector	prospetor
prospectora	prospetora
prostatopéctico	prostatopético
protecção	proteção
proteccional	protecional
proteccionismo	protecionismo
proteccionista	protecionista
protectivo	protetivo
protector	protetor
protectora	protetora
protectorado	protetorado
protectoral	protetoral
protectorato	protetorato
protectoria	protetoria
protectório	protetório
Proterozóico	Proterozoico
proto-alveitar	protoalveitar
proto-ária	protoária
proto-árico	protoárico
proto-estrela	protoestrela
proto-evangelho	protoevangelho
proto-renascimento	protorrenascimento
proto-revolução	protorrevolução
proto-revolucionário	protorrevolucionário
proto-romântico	protorromântico
proto-romantismo	protorromantismo
proto-romboedro	protorromboedro
proto-sincelo	protossincelo
proto-sol	protossol
proto-solar	protossolar
proto-sulfureto	protossulfureto
protozóide	protozoide
protráctil	protráctil, protrátil
prozóico	prozoico
pseudo-anemia	pseudoanemia
pseudo-anónimo	pseudoanónimo
pseudo-apatite	pseudoapatite
pseudo-apendicite	pseudoapendicite
pseudo-apóstolo	pseudoapóstolo
pseudo-arcaísmo	pseudoarcaísmo
pseudo-aticismo	pseudoaticismo
pseudo-ático	pseudoático
pseudo-eólico	pseudoeólico
pseudo-eolismo	pseudoeolismo
pseudo-escorpião	pseudoescorpião
pseudo-escorpionídeo	pseudoescorpionídeo
pseudo-esteatite	pseudoesteatite
pseudo-etimologia	pseudoetimologia
pseudo-etimológico	pseudoetimológico
pseudo-eufémico	pseudoeufémico
pseudo-eufemismo	pseudoeufemismo
pseudo-evangelista	pseudoevangelista
pseudo-iónico	pseudoiónico
pseudo-ionismo	pseudoionismo
pseudo-revelação	pseudorrevelação
pseudo-sábio	pseudossábio
pseudo-sínodo	pseudossínodo
pseudobaptizado	pseudobatizado
pseudodialectal	pseudodialetal
pseudorréctico	pseudorrético
psicoactivo	psicoativo
pterigóide	pterigoide
pteróide	pteroide
pulsorreactor	pulsorreator
punctiforme	punctiforme
punctura	punctura, puntura
putrefacção	putrefação
putrefactivo	putrefativo, putrefactivo
putrefactor	putrefator
putrefactório	putrefatório
quadrirreactor	quadrirreator
quapóia	quapoia
quarto-de-final	quarto de final
quartos-de-final	quartos de final
queijinho-do-céu	queijinho do céu
quelóide	queloide
quimiorrecepção	quimiorreceção
quimiorreceptividade	quimiorrecetividade
quimiorreceptivo	quimiorrecetivo
quimiorreceptor	quimiorrecetor
quimiotáctico	quimiotático
quimiotactismo	quimiotactismo, quimiotatismo
rabditóide	rabditoide
rabdóide	rabdoide
rabo-de-andorinha	rabo de andorinha
rabo-de-arraia	rabo de arraia
rabo-de-leque	rabo de leque
rabo-de-saia	rabo de saia
rabo-de-tatu	rabo de tatu
radiactividade	radiatividade
radiactivo	radiativo
radielectricidade	radieletricidade
radieléctrico	radielétrico
radioactividade	radioatividade
radioactivo	radioativo
radioelectricidade	radioeletricidade
radioeléctrico	radioelétrico
radioelectrónico	radioeletrónico
radiorreceptor	radiorrecetor
ragóide	ragoide
rambóia	ramboia
ranfóide	ranfoide
rarefacção	rarefação
rarefactibilidade	rarefactibilidade, rarefatibilidade
rarefactível	rarefatível, rarefactível
rarefactivo	rarefativo, rarefactivo
rarefactor	rarefator
rato-do-egipto	rato-do-egito
reacção	reação
reaccional	reacional
reaccionária	reacionária
reaccionariamente	reacionariamente
reaccionário	reacionário
reaccionarismo	reacionarismo
reaccionarista	reacionarista
reaccionismo	reacionismo
reaccionista	reacionista
reactivação	reativação
reactivado	reativado
reactivador	reativador
reactivar	reativar
reactividade	reatividade
reactivo	reativo
reactor	reator
reactualizar	reatualizar
readopção	readoção
readoptar	readotar
rebaptismo	rebatismo
rebaptizar	rebatizar
recepção	receção
recepcionado	rececionado
recepcionamento	rececionamento
recepcionante	rececionante
recepcionar	rececionar
recepcionável	rececionável
recepcionista	rececionista
receptação	recetação
receptacular	recetacular
receptáculo	recetáculo
receptado	recetado
receptador	recetador
receptadora	recetadora
receptar	recetar
receptibilidade	recetibilidade
receptiva	recetiva
receptível	recetível
receptividade	recetividade
receptivo	recetivo
receptor	recetor
receptora	recetora
recolecção	recoleção
recolecta	recoleta
recolecto	recoleto
recorrecção	recorreção
recta	reta
recta-pronúncia	reta-pronúncia
rectal	retal, rectal
rectalgia	retalgia
rectamente	retamente
rectangular	retangular
rectangularidade	retangularidade
rectangularmente	retangularmente
rectângulo	retângulo
recticórneo	reticórneo
rectidão	retidão
rectificação	retificação
rectificador	retificador
rectificar	retificar
rectificativo	retificativo
rectificável	retificável
rectifloro	retifloro
rectiforme	retiforme
rectígrado	retígrado
rectilineamente	retilineamente
rectilinearidade	retilinearidade
rectilíneo	retilíneo
rectinérveo	retinérveo
rectiparalelinérveo	retiparalelinérveo
rectirrostro	retirrostro
rectite	retite
rectitude	retitude
recto	reto
recto-uretral	retouretral
rectocele	retocele
rectococcígeo	retococcígeo
rectocolite	retocolite
rectopéctico	retopético
rectopexia	retopexia
rector	retor
rectoscopia	retoscopia
rectoscópico	retoscópico
rectoscópio	retoscópio
rectotomia	retotomia
rectotómico	retotómico
rectovaginal	retovaginal
rectovesical	retovesical
rectricial	retricial
rectriz	retriz
recturetral	returetral
redacção	redação
redactor	redator
redactor-chefe	redator-chefe
redactor-secretário	redator-secretário
redactora	redatora
redactora-chefe	redatora-chefe
redactorial	redatorial
redireccionar	redirecionar
reelectrómetro	reeletrómetro
refectivo	refetivo
refectório	refetório
reflectidamente	refletidamente
reflectido	refletido
reflectidor	refletidor
reflectir	refletir
reflectividade	refletividade
reflectivo	refletivo
reflectografia	refletografia, reflectografia
reflectográfico	refletográfico, reflectográfico
reflectométrico	refletométrico, reflectométrico
reflectómetro	reflectómetro, refletómetro
reflector	refletor
refracção	refração
refractar	refratar
refractariamente	refratariamente
refractário	refratário
refractarismo	refratarismo
refractividade	refratividade
refractivo	refrativo
refracto	refrato
refractometria	refratometria
refractométrico	refratométrico
refractómetro	refratómetro
refractor	refrator
refractoscópico	refratoscópico
refractoscópio	refratoscópio
regiolectal	regioletal
regiolecto	regioleto
réida	reida
reinfecção	reinfeção
reinfeccionar	reinfecionar
relógio-de-ponto	relógio de ponto
reotáctico	reotático
rés-do-chão	rés do chão
resina-de-jalapa	resina de jalapa
resinóide	resinoide
respectivamente	respetivamente
respectivo	respetivo
ressurreccional	ressurrecional
ressurreccionismo	ressurrecionismo
ressurreccionista	ressurrecionista
ressurrecto	ressurreto
retinóide	retinoide
reto-românico	retorromânico
retracção	retração
retractação	retratação
retractar	retratar
retractável	retratável
retráctil	retráctil, retrátil
retractilidade	retractilidade, retratilidade
retractivamente	retrativamente, retractivamente
retractivo	retractivo, retrativo
retracto	retracto, retrato
retroacção	retroação
retroactivamente	retroativamente
retroactividade	retroatividade
retroactivo	retroativo
retroactor	retroator
retroflectido	retrofletido
retroflectir	retrofletir
retroprojecção	retroprojeção
retroprojectar	retroprojetar
retroprojector	retroprojetor
retrospecção	retrospeção
retrospectiva	retrospetiva
retrospectivamente	retrospetivamente
retrospectividade	retrospetividade
retrospectivo	retrospetivo
retrospecto	retrospeto
retrotracção	retrotração
reumatóide	reumatoide
ríccia	rícia
ricciáceas	riciácea
rinenfráctico	rinenfrático
rizóide	rizoide
rizotáctico	rizotático
rombóide	romboide
rosa-de-oiro	rosa de oiro
rosa-de-ouro	rosa de ouro
rosa-dos-ventos	rosa dos ventos
roupa-de-franceses	roupa de franceses
rubefacção	rubefação
ruptura	rutura
sabóia	saboia
saca-de-carvão	saca de carvão
saca-projéctil	saca-projétil
sacaróide	sacaroide
saco-de-areia	saco de areia
saída-de-banho	saída de banho
saída-de-praia	saída de praia
sal-de-azedas	sal de azedas
sal-de-epsom	sal de Epsom
sal-de-glauber	sal de Glauber
sal-de-júpiter	sal de Júpiter
sal-de-saturno	sal de Saturno
sal-de-seldlitz	sal de Seldlitz
sal-de-vichy	sal de Vichy
saprozóico	saprozoico
sarcóide	sarcoide
sarcopióide	sarcopioide
secantóide	secantoide
sector	setor, sector
sectorial	sectorial, setorial
sectorização	sectorização
sectorizar	sectorizar
selecção	seleção
seleccionada	selecionada
seleccionado	selecionado
seleccionador	selecionador
seleccionadora	selecionadora
seleccionamento	selecionamento
seleccionar	selecionar
seleccionável	selecionável
seleccionismo	selecionismo
seleccionista	selecionista
selecta	seleta
selectar	seletar
selectivamente	seletivamente
selectividade	seletividade
selectivo	seletivo
selecto	seleto
selector	seletor
selenóide	selenoide
semi-esferóide	semiesferoide
semi-racional	semirracional
semi-radiado	semirradiado
semi-real	semirreal
semi-reboque	semirreboque
semi-recta	semirreta
semi-recto	semirreto
semi-rei	semirrei
semi-religioso	semirreligioso
semi-rígido	semirrígido
semi-romano	semirromano
semi-roto	semirroto
semi-sábio	semissábio
semi-sagitado	semissagitado
semi-secular	semissecular
semi-sedentário	semissedentário
semi-segredo	semissegredo
semi-selvagem	semisselvagem
semi-septenário	semisseptenário
semi-sepulto	semissepulto
semi-silvestre	semissilvestre
semi-soberania	semissoberania
semi-soberano	semissoberano
semi-som	semissom
semi-soma	semissoma
semi-sonora	semissonora
semi-sonoro	semissonoro
semiesferóide	semiesferoide
senóide	senoide
sentimentalóide	sentimentaloide
sepalóide	sepaloide
séptico	séptico, sético
septuplicar	septuplicar, setuplicar
séptuplo	séptuplo, sétuplo
sequóia	sequoia
sericóia	sericoia
sesamóide	sesamoide
Setembro	setembro
Sicrano	sicrano
sifilóide	sifiloide
sifonóide	sifonoide
sigmóide	sigmoide
siluróide	siluroide
simpléctico	simplético
sinóico	sinoico
sintacticamente	sintaticamente
sintacticista	sintaticista
sintáctico	sintático
sintoxóide	sintoxoide
sinusóide	sinusoide
sobreelevar	sobre-elevar
sobreeminência	sobre-eminência
sobreeminente	sobre-eminente
sobreemissão	sobre-emissão
sobreendividamento	sobre-endividamento
sobreendividar	sobre-endividar
sobreerguer	sobre-erguer
sobreerrogação	sobre-errogação
sobreexaltação	sobre-exaltação
sobreexaltar	sobre-exaltar
sobreexcedente	sobre-excedente
sobreexceder	sobre-exceder
sobreexcelência	sobre-excelência
sobreexcelente	sobre-excelente
sobreexcitação	sobre-excitação
sobreexcitado	sobre-excitado
sobreexcitante	sobre-excitante
sobreexcitar	sobre-excitar
sobreexploração	sobre-exploração
sobreexpor	sobre-expor
sobreexposição	sobre-exposição
sobrefacturação	sobrefaturação
sobrejecção	sobrejeção
sobrejectiva	sobrejetiva
sobrejectivo	sobrejetivo
sociolectal	socioletal
sociolecto	socioleto
sóia	soia
sol-de-gata	sol de gata
solenóide	solenoide
sopa-de-urso	sopa de urso
sopinha-de-massa	sopinha de massa
subacepção	subaceção
subaracnóide	subaracnoide
subárctico	subártico
subdialectal	subdialetal
subdialecto	subdialeto
subdirecção	subdireção
subdirector	subdiretor
subdirector-geral	subdiretor-geral
subdirectora	subdiretora
subdirectoria	subdiretoria
subdirectório	subdiretório
subicterícia	subicterícia, subiterícia
subictérico	subictérico, subitérico
subinspecção	subinspeção
subinspector	subinspetor
subinspectora	subinspetora
subinspectoria	subinspetoria
subjecção	subjeção
subjectivação	subjetivação
subjectivamente	subjetivamente
subjectivar	subjetivar
subjectividade	subjetividade
subjectivismo	subjetivismo
subjectivista	subjetivista
subjectivístico	subjetivístico
subjectivizar	subjetivizar
subjectivo	subjetivo
subsector	subsetor, subsector
subtracção	subtração
subtractivamente	subtrativamente
subtractivo	subtrativo
subtractor	subtrator
subtractora	subtratora
sulfuróide	sulfuroide
superactivado	superativado
superactividade	superatividade
superactivo	superativo
superinfecção	superinfeção
superprotecção	superproteção
supra-escapular	supraescapular
supra-esternal	supraesternal
supra-estrutura	supraestrutura
supra-excitar	supraexcitar
supra-occipital	supraoccipital
supra-ocular	supraocular
supra-orbital	supraorbital
supra-orbitário	supraorbitário
supra-racial	suprarracial
supra-racional	suprarracional
supra-regional	suprarregional
supra-renal	suprarrenal
supra-renalite	suprarrenalite
supra-sensibilidade	suprassensibilidade
supra-sensível	suprassensível
supra-sumo	suprassumo
suscepção	susceção
susceptibilidade	suscetibilidade
susceptibilizar	suscetibilizar
susceptível	suscetível
suspensóide	suspensoide
tablóide	tabloide
tacteabilidade	tateabilidade
tacteadamente	tateadamente
tacteamento	tateamento
tacteante	tateante
tactear	tatear
tacteável	tateável
tacteio	tateio
táctica	tática
tacticamente	taticamente
táctico	tático
tacticografia	tacticografia, taticografia
tacticográfico	tacticográfico, taticográfico
tacticógrafo	tacticógrafo, taticógrafo
táctil	táctil, tátil
tactilidade	tactilidade, tatilidade
tactilmente	tactilmente, tatilmente
tactismo	tactismo, tatismo
tacto	tato
talagóia	talagoia
tangentóide	tangentoide
técnico-táctico	técnico-tático
tecnolectal	tecnoletal
tecnolecto	tecnoleto
tecto	teto
tele-receptor	telerrecetor
teledetecção	teledeteção
teledetectar	teledetetar
teleobjectiva	teleobjetiva
teleprojéctil	teleprojétil
telespectador	telespectador, telespetador
telespectadora	telespectadora, telespetadora
telobjectiva	telobjetiva
telóptico	telótico
tenióide	tenioide
ténis-de-mesa	ténis de mesa
tenontopéctico	tenontopético
tenopéctico	tenopético
tensioactivo	tensioativo
tepalóide	tepaloide
termelectricidade	termeletricidade
termeléctrico	termelétrico
termocróico	termocroico
termodieléctrico	termodielétrico
termoelectricidade	termoeletricidade
termoeléctrico	termoelétrico
termotáctico	termotático
termotactismo	termotatismo, termotactismo
terra-a-terra	terra a terra
terra-de-ninguém	terra de ninguém
terra-de-sevilha	terra de Sevilha
terra-de-siena	terra de Siena
testa-de-ferro	testa de ferro
testa-de-ponte	testa de ponte
tetraplóide	tetraploide
tiflopéctico	tiflopético
tifóide	tifoide
tigmotáctico	tigmotático
tigmotactismo	tigmotatismo, tigmotactismo
tigróide	tigroide
tilacóide	tilacoide
tinta-da-china	tinta da China
tipóia	tipoia
tireóide	tireoide
tiro-de-guerra	tiro de guerra
tiróide	tiroide
tirsóide	tirsoide
tóino	toino
torrão-de-alicante	torrão de Alicante
torrefacção	torrefação
torrefactor	torrefator
toucinho-do-céu	toucinho do céu
tourão-do-mato	tourão-do-mato
toxicóide	toxicoide
toxóide	toxoide
tracção	tração
traccionar	tracionar
tracóide	tracoide
tracto	trato
tractocarro	tratocarro
tractor	trator
tractório	tratório
tractorista	tratorista
trairambóia	trairamboia
trajecto	trajeto
trajector	trajetor
trajectória	trajetória
tramóia	tramoia
transacção	transação
transaccionador	transacionador
transaccionadora	transacionadora
transaccional	transacional
transaccionar	transacionar
transaccionável	transacionável
transaccionista	transacionista
transacto	transato
transactor	transator
transactora	transatora
transceptor	transcetor
transobjectivo	transobjetivo
trapezóide	trapezoide
traquelopéctico	traquelopético
traqueóide	traqueoide
traquitóide	traquitoide
triboelectricidade	triboeletricidade
triboeléctrico	triboelétrico
tricóide	tricoide
tricorréctico	tricorrético
tricróico	tricroico
trióico	trioico
triplóide	triploide
trirrectângulo	trirretângulo
trissectriz	trissetriz, trissectriz
trocóide	trocoide
trofotactismo	trofotatismo, trofotactismo
tróia	troia
tróica	troica
tróico	troico
troixa-de-ovos	troixa de ovos
tromba-de-boi	tromba de boi
trombóide	tromboide
trouxa-de-ovos	trouxa de ovos
tuberculóide	tuberculoide
tuberóide	tuberoide
tucanabóia	tucanaboia
tumefacção	tumefação
turbinosfenóide	turbinosfenoide
turbinosfenóideo	turbinosfenoideo
turborreactor	turborreator
uarurembóia	uaruremboia
ulceróide	ulceroide
ulcóide	ulcoide
ultra-esdrúxulo	ultraesdrúxulo
ultra-etimológico	ultraetimológico
ultra-existência	ultraexistência
ultra-existente	ultraexistente
ultra-infernal	ultrainfernal
ultra-oceânico	ultraoceânico
ultra-ortodoxo	ultraortodoxo
ultra-radical	ultrarradical
ultra-rápido	ultrarrápido
ultra-reacção	ultrarreação
ultra-reaccionária	ultrarreacionária
ultra-reaccionário	ultrarreacionário
ultra-realismo	ultrarrealismo
ultra-realista	ultrarrealista
ultra-revolucionária	ultrarrevolucionária
ultra-revolucionário	ultrarrevolucionário
ultra-rigoroso	ultrarrigoroso
ultra-romântica	ultrarromântica
ultra-romântico	ultrarromântico
ultra-romantismo	ultrarromantismo
ultra-romantizar	ultrarromantizar
ultra-roxo	ultrarroxo
ultra-secreto	ultrassecreto
ultra-secular	ultrassecular
ultra-sensível	ultrassensível
ultra-sofisticado	ultrassofisticado
ultra-solar	ultrassolar
ultra-som	ultrassom
ultra-sónico	ultrassónico
ultra-sonografia	ultrassonografia
ultra-sonográfico	ultrassonográfico
ultra-sonógrafo	ultrassonógrafo
ultra-sonoro	ultrassonoro
ultra-terreno	ultraterreno
ultracorrecção	ultracorreção
ultracorrecto	ultracorreto
umbigo-de-freira	umbigo de freira
unha-de-fome	unha de fome
unhas-de-fome	unhas de fome
unidireccional	unidirecional
ureterenfráctico	ureterenfrático
uretrofráctico	uretrofrático
uretrorrectal	uretrorretal, uretrorrectal
uretrotrombóide	uretrotromboide
urobenzóico	urobenzoico
uróide	uroide
vacinóide	vacinoide
vaginorrectal	vaginorrectal, vaginorretal
varicelóide	variceloide
variolóide	varioloide
vasoactivo	vasoativo
vectação	vetação
vector	vetor
vectorial	vetorial
vectorizar	vetorizar
vectrice	vetrice
vedóia	vedoia
venipunctura	venipuntura, venipunctura
Verão	verão
verbo-de-encher	verbo de encher
veredicto	veredicto, veredito
vesicorrectal	vesicorretal, vesicorrectal
vice-colector	vice-coletor
vice-direcção	vice-direção
vice-director	vice-diretor
vice-directora	vice-diretora
vice-directoria	vice-diretoria
vidro-de-cheiro	vidro de cheiro
vinho-de-caju	vinho de caju
vinho-de-cheiro	vinho de cheiro
vinho-de-maçã	vinho de maçã
vinho-de-maçãs	vinho de maçãs
vinho-de-palma	vinho de palma
vinte-e-quatro-horas	vinte e quatro horas
vintém-de-santo-antónio	vintém de Santo António
viola-da-terra	viola da terra
viola-de-amor	viola de amor
viola-de-arame	viola de arame
volta-no-meio	volta no meio
x-acto	x-ato
xifóide	xifoide
xilóide	xiloide
xistóide	xistoide
zé-da-véstia	zé da véstia
zé-dos-anzóis	zé dos anzois
zebróide	zebroide
zéida	zeida
zigotáctico	zigotático
zigotactismo	zigotatismo, zigotactismo
zoelectricidade	zoeletricidade
zoeléctrico	zoelétrico
zóico	zoico
zóide	zoide
zooelectricidade	zooeletricidade
zooeléctrico	zooelétrico
zoofitóide	zoofitoide
zoóide	zooide
zoóptico	zoótico
zootáctico	zootático