	BR	PT
abatista/abaptista	abatista	abatista
abjeção/abjecção	abjeção	abjeção
abjecionista/abjeccionista	abjecionista	abjecionista
abjetamente/abjectamente	abjetamente	abjetamente
abjeto/abjecto	abjeto	abjeto
acataleto/acatalecto	acatalecto	acataleto
acataleto/acatalecto	acataleto	acataleto
adoção/adopção	adoção	adoção
adocionismo/adopcionismo	adocionismo	adocionismo
adotado/adoptado	adotado	adotado
adotante/adoptante	adotante	adotante
adotar/adoptar	adotar	adotar
adotável/adoptável	adotável	adotável
adotiva/adoptiva	adotiva	adotiva
adotivamente/adoptivamente	adotivamente	adotivamente
adotivo/adoptivo	adotivo	adotivo
afeção/afecção	afeção	afeção
afeção/afecção	afecção	afeção
afetação/afectação	afetação	afetação
afetada/afectada	afetada	afetada
afetadamente/afectadamente	afetadamente	afetadamente
afetado/afectado	afetado	afetado
afetador/afectador	afetador	afetador
afetante/afectante	afetante	afetante
afetar/afectar	afetar	afetar
afetativo/afectativo	afetativo	afetativo
afetável/afectável	afetável	afetável
afetivamente/afectivamente	afetivamente	afetivamente
afetível/afectível	afectível	afectível
afetível/afectível	afetível	afectível
afetividade/afectividade	afetividade	afetividade
afetivo/afectivo	afetivo	afetivo
afeto/afecto	afeto	afeto
afetuosamente/afectuosamente	afetuosamente	afetuosamente
afetuosidade/afectuosidade	afetuosidade	afetuosidade
afetuoso/afectuoso	afetuoso	afetuoso
afilático/afiláctico	afilático	afilático
amiotático/amiotáctico	amiotáctico	amiotático
amiotático/amiotáctico	amiotático	amiotático
ampletivo/amplectivo	ampletivo	ampletivo
anabatismo/anabaptismo	anabatismo	anapatismo
anabatista/anabaptista	anabatista	anabatista
anafilático/anafiláctico	anafilático	anafilático
anaptítico/anaptíctico	anaptíctico	anaptítico
anaptítico/anaptíctico	anaptítico	anaptítico
androlético/androléptico	androléptico	androlético
androlético/androléptico	androlético	androlético
anelétrico/aneléctrico	anelétrico	anelétrico
aneletródio/anelectródio	anelectródio	aneletródio
aneletródio/anelectródio	aneletródio	aneletródio
anelétrodo/aneléctrodo	aneléctrodo	anelétrodo
anelétrodo/aneléctrodo	anelétrodo	anelétrodo
anótico/anóptico	anóptico	anótico
anótico/anóptico	anótico	anóptico
antártico/antárctico	antárctico	antártico
antártico/antárctico	antártico	antártico
anti-infeciosamente/anti-infecciosamente	anti-infecciosamente	anti-infeciosamente
anti-infeciosamente/anti-infecciosamente	anti-infeciosamente	anti-infeciosamente
anti-infecioso/anti-infeccioso	anti-infeccioso	anti-infecioso
anti-infecioso/anti-infeccioso	anti-infecioso	anti-infecioso
antiapoplético/antiapopléctico	antiapopléctico	antiapoplético
antiapoplético/antiapopléctico	antiapoplético	antiapoplético
antiatático/antiatáctico	antiatáctico	antiatático
antiatático/antiatáctico	antiatático	antiatático
antiepilético/antiepiléptico	antiepiléptico	antiepilético
antiepilético/antiepiléptico	antiepilético	antiepilético
antiferroelétrico/antiferroeléctrico	antiferroelétrico	antiferroelétrico
antimetalético/antimetaléptico	antimetaléptico	antimetalético
antimetalético/antimetaléptico	antimetalético	antimetalético
antropotático/antropotáctico	antropotáctico	antropotático
antropotático/antropotáctico	antropotático	antropotático
apodítica/apodíctica	apodíctica	apodítica
apodítica/apodíctica	apodítica	apodítica
apodítico/apodíctico	apodíctico	apodítico
apodítico/apodíctico	apodítico	apodítico
apomítico/apomíctico	apomítico	apomítico
apoplético/apopléctico	apopléctico	apoplético
apoplético/apopléctico	apoplético	apoplético
apotático/apotáctico	apotáctico	apotático
apotático/apotáctico	apotático	apotático
ártico/árctico	árctico	ártico
ártico/árctico	ártico	ártico
aspeto/aspecto	aspecto	aspeto
aspectual/aspetual	aspectual	aspetual
assintático/assintáctico	assintático	assintático
assuncionista/assumpcionista	assuncionista	assumcionista
autoinfeção/autoinfecção	autoinfecção	autoinfeção
batismal/baptismal	batismal	batismal
batismo/baptismo	batismo	batismo
batista/baptista	batista	batista
batistério/baptistério	batistério	batistério
batistino/baptistino	batistino	batistino
barotático/barotáctico	barotáctico	barotático
barotático/barotáctico	barotático	barotático
bibliofilático/bibliofiláctico	bibliofiláctico	bibliofilático
bibliofilático/bibliofiláctico	bibliofilático	bibliofilático
bijeção/bijecção	bijeção	bijeção
bioelétrico/bioeléctrico	bioelétrico	bioelétrico
biotático/biotáctico	biotático	biotático
biotático/biotáctico	biotáctico	biotático
birrefração/birrefracção	birrefração	birrefração
bissetriz/bissectriz	bissetriz	bissetriz
braquicatalético/braquicataléctico	braquicataléctico	braquicatalético
braquicatalético/braquicataléctico	braquicatalético	braquicatalético
braquicataleto/braquicatalecto	braquicatalecto	braquicataleto
braquicataleto/braquicatalecto	braquicataleto	braquicataleto
bronquetático/bronquectático	bronquectático	bronquetático
bronquetático/bronquectático	bronquetático	bronquetático
calefator/calefactor	calefator	calefator
catabatismo/catabaptismo	catabatismo	catabatismo
catabatista/catabaptista	catabatista	catabatista
catafilático/catafiláctico	catafilático	catafilático
catalético/cataléctico	cataléctico	catalético
catalético/cataléctico	catalético	catalético
cataleto/catalecto	catalecto	cataleto
cataleto/catalecto	cataleto	cataleto
catarrético/catarréctico	catarréctico	catarrético
catarrético/catarréctico	catarrético	catarrético
cética/céptica	cética	cética
ceticismo/cepticismo	ceticismo	ceticismo
cético/céptico	cético	cético
cetrífero/ceptrífero	ceptrífero	cetrífero
cetrífero/ceptrífero	cetrífero	cetrífero
cetrígero/ceptrígero	ceptrígero	cetrígero
cetrígero/ceptrígero	cetrígero	cetrígero
ciótico/cióptico	cióptico	ciótico
ciótico/cióptico	ciótico	ciótico
circunspeção/circunspecção	circunspecção	circunspeção
circunspeção/circunspecção	circunspeção	circunspeção
circunspecionar/circunspeccionar	circunspeccionar	circunspecionar
circunspecionar/circunspeccionar	circunspecionar	circunspecionar
citofilático/citofiláctico	citofilático	citofilático
citopético/citopéctico	citopéctico	citopético
citopético/citopéctico	citopético	citopéctico
codialeto/codialecto	codialeto	codialeto
coatar/coactar	coatar	coatar
coativamente/coactivamente	coativamente	coativamente
coatividade/coactividade	coatividade	coatividade
coativo/coactivo	coativo	coativo
coator/coactor	coator	coator
coatora/coactora	coatora	coatora
coartação/coarctação	coarctação	coartação
coartação/coarctação	coartação	coartação
coartada/coarctada	coarctada	coartada
coartada/coarctada	coartada	coartada
coartar/coarctar	coarctar	coartar
coartar/coarctar	coartar	coarctar
coartativo/coarctativo	coarctativo	coartativo
coartativo/coarctativo	coartativo	coartativo
cofator/cofactor	cofator	cofator
coleta/colecta	coleta	coleta
coletânea/colectânea	coletânea	coletânea
coletâneo/colectâneo	coletâneo	coletâneo
coletar/colectar	coletar	coletar
coletário/colectário	coletário	coletário
coletável/colectável	coletável	coletável
coletício/colectício	coletício	coletício
coletivamente/colectivamente	coletivamente	coletivamente
coletividade/colectividade	coletividade	coletividade
coletivismo/colectivismo	coletivismo	coletivismo
coletivista/colectivista	coletivista	coletivista
coletivístico/colectivístico	coletivístico	coletivístico
coletivização/colectivização	coletivização	coletivização
coletivizar/colectivizar	coletivizar	coletivizar
coletivo/colectivo	coletivo	coletivo
coletor/colector	coletor	coletor
coletora/colectora	coletora	coletora
coletoria/colectoria	coletoria	coletoria
colopético/colopéctico	colopéctico	colopético
colopético/colopéctico	colopético	colopético
conjetânea/conjectânea	conjectânea	conjetânea
conjetânea/conjectânea	conjetânea	conjetânea
conjetura/conjectura	conjectura	conjetura
conjetura/conjectura	conjetura	conjetura
conjeturabilidade/conjecturabilidade	conjecturabilidade	conjeturabilidade
conjeturabilidade/conjecturabilidade	conjeturabilidade	conjeturabilidade
conjeturador/conjecturador	conjecturador	conjeturador
conjeturador/conjecturador	conjeturador	conjeturador
conjetural/conjectural	conjectural	conjetural
conjetural/conjectural	conjetural	conjetural
conjeturalmente/conjecturalmente	conjecturalmente	conjeturalmente
conjeturalmente/conjecturalmente	conjeturalmente	conjeturalmente
conjeturante/conjecturante	conjecturante	conjeturante
conjeturante/conjecturante	conjeturante	conjeturante
conjeturar/conjecturar	conjecturar	conjeturar
conjeturar/conjecturar	conjeturar	conjeturar
conjeturável/conjecturável	conjecturável	conjeturável
conjeturável/conjecturável	conjeturável	conjeturável
conjeturista/conjecturista	conjecturista	conjeturista
conjeturista/conjecturista	conjeturista	conjeturista
contrafator/contrafactor	contrafator	contrafator
convetor/convector	convector	convetor
correspetivo/correspectivo	correspectivo	correspetivo
cristalelétrico/cristaleléctrico	cristalelétrico	cristalelétrico
defletográfico/deflectográfico	deflectográfico	defletográfico
defletográfico/deflectográfico	defletográfico	defletográfico
defletógrafo/deflectógrafo	deflectógrafo	defletógrafo
defletógrafo/deflectógrafo	defletógrafo	deflectógrafo
defletométrico/deflectométrico	deflectométrico	defletométrico
defletométrico/deflectométrico	defletométrico	deflectométrico
dejeção/dejecção	dejeção	dejeção
dejetar/dejectar	dejetar	dejetar
dejeto/dejecto	dejeto	dejeto
dejetório/dejectório	dejetório	dejetório
desafetação/desafectação	desafetação	desafetaçãi
desafetadamente/desafectadamente	desafetadamente	desafetadamente
desafetado/desafectado	desafetado	desafetado
desafetar/desafectar	desafetar	desafetar
desafeto/desafecto	desafeto	desafeto
deseletrizar/deselectrizar	deseletrizar	deseletrizar
deseletrizável/deselectrizável	deseletrizável	deseletrizável
desinfeção/desinfecção	desinfecção	desinfeção
desinfecionar/desinfeccionar	desinfeccionar	desinfecionar
desinfetador/desinfectador	desinfetador	desinfetador
desinfetante/desinfectante	desinfetante	desinfetante
desinfetar/desinfectar	desinfetar	desinfetar
desinfetável/desinfectável	desinfetável	desinfetável
desinfetório/desinfectório	desinfetório	desinfetório
detetabilidade/detectabilidade	detectabilidade	detetabilidade
detetar/detectar	detectar	detetar
detetável/detectável	detectável	detetável
detetiva/detectiva	detetiva	detetiva
detetive/detective	detetive	detetive
detetor/detector	detector	detetor
dialetal/dialectal	dialetal	dialetal
dialetalmente/dialectalmente	dialetalmente	dialetalmente
dialética/dialéctica	dialética	dialética
dialeticamente/dialecticamente	dialeticamente	dialeticamente
dialético/dialéctico	dialético	dialético
dialetismo/dialectismo	dialetismo	dialetismo
dialetista/dialectista	dialetista	dialetista
dialetização/dialectização	dialetização	dialetização
dialetizar/dialectizar	dialetizar	dialetizar
dialeto/dialecto	dialeto	dialeto
dialetologia/dialectologia	dialetologia	dialetologia
dialetológico/dialectológico	dialetológico	dialetológico
dialetologista/dialectologista	dialetologista	dialetologista
dialetólogo/dialectólogo	dialetólogo	dialetólogo
dicatalético/dicataléctico	dicataléctico	dicatalético
dicatalético/dicataléctico	dicatalético	dicatalético
dielétrico/dieléctrico	dielétrico	dielétrico
dinamoelétrico/dinamoeléctrico	dinamoelétrico	dinamodielétrico
dislético/disléctico	disléctico	dislético
dislético/disléctico	dislético	dislético
disorético/disoréctico	disoréctico	disorético
disorético/disoréctico	disorético	disorético
distático/distáctico	distáctico	distático
distático/distáctico	distático	distático
distrátil/distráctil	distrátil	distrátil
distrativo/distractivo	distrativo	distrativo
ecfrático/ecfráctico	ecfrático	ecfrático
efetivador/efectivador	efetivador	efetivador
efração/efracção	efração	efração
efratura/efractura	efratura	efratura
ejeção/ejecção	ejeção	ejeção
ejetar/ejectar	ejetar	ejetar
ejetável/ejectável	ejetável	ejetável
ejetólito/ejectólito	ejetólito	ejetólito
ejetor/ejector	ejetor	ejetor
eletracústica/electracústica	eletracústica	eletracústica
eletrão/electrão	eletrão	eletrão
eletrão-volt/electrão-volt	eletrão-volt	 eletrão-volt
eletrargol/electrargol	electrargol	eletrargol
eletrargol/electrargol	eletrargol	eletrargol
eletrencefalografia/electrencefalografia	eletrencefalografia	eletrencefalografia
eletrencefalográfico/electrencefalográfico	eletrencefalográfico	eletrencefalográfico
eletrencefalograma/electrencefalograma	eletrencefalograma	eletrencefalograma
eletrete/electrete	eletrete	eletrete
eletrexecução/electrexecução	eletrexecução	eletrexecução
eletricamente/electricamente	eletricamente	eletricamente
elétrico/eléctrico	elétrico	elétrico
eletrificação/electrificação	eletrificação	eletrificação
eletrificador/electrificador	eletrificador	eletrificador
eletrificar/electrificar	eletrificar	eletrificar
eletrificável/electrificável	eletrificável	eletrificável
eletríman/electríman	eletroimã	eletríman
elétrino/eléctrino	elétrino	elétrino
eletrização/electrização	eletrização	eletrização
eletrizador/electrizador	eletrizador	eletrizador
eletrizante/electrizante	eletrizante	eletrizante
eletrizar/electrizar	eletrizar	eletrizar
eletrizável/electrizável	eletrizável	eletrizável
eletroacústico/electroacústico	eletroacústico	eletroacústico
eletrobalística/electrobalística	eletrobalística	eletrobalística
eletrobiologia/electrobiologia	eletrobiologia	eletrobiologia
eletrobiológico/electrobiológico	eletrobiológico	eletrobiológico
eletrobomba/electrobomba	eletrobomba	eletrobomba
eletrocardiografia/electrocardiografia	eletrocardiografia	eletrocardiografia
eletrocardiográfico/electrocardiográfico	eletrocardiográfico	eletrocardiográfico
eletrocardiógrafo/electrocardiógrafo	eletrocardiógrafo	eletrocardiógrafo
eletrocardiograma/electrocardiograma	eletrocardiograma	eletrocardiograma
eletrochoque/electrochoque	eletrochoque	eletrochoque
eletrocinética/electrocinética	eletrocinética	eletrocinética
eletrocinético/electrocinético	eletrocinético	eletrocinético
eletrocirurgia/electrocirurgia	eletrocirurgia	eletrocirurgia
eletrocoagulação/electrocoagulação	eletrocoagulação	eletrocoagulação
eletrocultura/electrocultura	eletrocultura	eletrocultura
eletrocussão/electrocussão	eletrocussão	eletrocussão
eletrocutado/electrocutado	eletrocutado	eletrocutado
eletrocutar/electrocutar	eletrocutar	eletrocutar
eletrocutir/electrocutir	eletrocutir	eletrocutir
eletrocutor/electrocutor	eletrocutor	eletrocutor
eletrodeposição/electrodeposição	eletrodeposição	eletrodeposição
eletrodiagnóstico/electrodiagnóstico	eletrodiagnóstico	eletrodiagnóstico
eletrodiálise/electrodiálise	eletrodiálise	eletrodiálise
eletrodinâmica/electrodinâmica	eletrodinâmica	eletrodinâmica
eletrodinâmico/electrodinâmico	eletrodinâmico	eletrodinâmico
eletrodinamismo/electrodinamismo	eletrodinamismo	eletrodinamismo
eletródio/electródio	eletródio	electródio
elétrodo/eléctrodo	elétrodo	eléctrodo
eletrodoméstico/electrodoméstico	eletrodoméstico	eletrodoméstico
eletroencefalografia/electroencefalografia	eletroencefalografia	eletroencefalografia
eletroencefalográfico/electroencefalográfico	eletroencefalográfico	eletroencefalográfico
eletroencefalógrafo/electroencefalógrafo	eletroencefalógrafo	eletroencefalógrafo
eletroencefalograma/electroencefalograma	eletroencefalograma	eletroencefalograma
eletrófilo/electrófilo	eletrófilo	electrófilo
eletrofisiologia/electrofisiologia	eletrofisiologia	eletrofisiologia
eletrofisiológico/electrofisiológico	eletrofisiológico	eletrofisiológico
eletrofone/electrofone	eletrofone	eletrofone
eletroforese/electroforese	eletroforese	eletroforese
eletroformação/electroformação	eletroformação	eletroformação
eletróforo/electróforo	eletróforo	electróforo
eletrofotografia/electrofotografia	eletrofotografia	eletrofotografia
eletrofotográfico/electrofotográfico	eletrofotográfico	eletrofotográfico
eletrogalvânico/electrogalvânico	eletrogalvânico	eletrogalvânico
eletrogalvanismo/electrogalvanismo	eletrogalvanismo	eletrogalvanismo
eletrogenético/electrogenético	eletrogenético	eletrogenético
eletrógeno/electrógeno	eletrógeno	electrógeno
eletrogerador/electrogerador	eletrogerador	eletrogerador
eletrografia/electrografia	eletrografia	eletrografia
eletrográfico/electrográfico	eletrográfico	eletrográfico
eletrógrafo/electrógrafo	eletrógrafo	electrógrafo
eletrolisação/electrolisação	eletrolisação	eletrolisação
eletrolisador/electrolisador	eletrolisador	eletrolisador
eletrolisar/electrolisar	eletrolisar	eletrolisar
eletrolisável/electrolisável	eletrolisável	eletrolisável
eletrólise/electrólise	eletrólise	electrólise
eletrolítico/electrolítico	eletrolítico	eletrolítico
eletrólito/electrólito	eletrólito	electrólito
eletrologia/electrologia	eletrologia	eletrologia
eletrológico/electrológico	eletrológico	eletrológico
eletroluminescência/electroluminescência	eletroluminescência	eletroluminescência
eletroluminescente/electroluminescente	eletroluminescente	eletroluminescente
eletromagnete/electromagnete	eletromagnete	eletromagnete
eletromagnético/electromagnético	eletromagnético	eletromagnético
eletromagnetismo/electromagnetismo	eletromagnetismo	eletromagnetismo
eletromecânica/electromecânica	eletromecânica	eletromecânica
eletromecânico/electromecânico	eletromecânico	eletromecânico
eletromeopatia/electromeopatia	eletromeopatia	eletromeopatia
eletrometalurgia/electrometalurgia	eletrometalurgia	eletrometalurgia
eletrometalúrgico/electrometalúrgico	eletrometalúrgico	eletrometalúrgico
eletrometria/electrometria	eletrometria	eletrometria
eletrométrico/electrométrico	eletrométrico	eletrométrico
eletromiografia/electromiografia	eletromiografia	eletromiografia
eletromiograma/electromiograma	eletromiograma	eletromiograma
eletromotor/electromotor	eletromotor	eletromotor
eletromotriz/electromotriz	eletromotriz	eletromotriz
eletromóvel/electromóvel	eletromóvel	eletromóvel
elétron/eléctron	elétron	eléctron
eletronegatividade/electronegatividade	eletronegatividade	eletronegatividade
eletronegativo/electronegativo	eletronegativo	eletronegativo
eletronicamente/electronicamente	eletronicamente	eletronicamente
eletropexia/electropexia	eletropexia	eletropexia
eletropositividade/electropositividade	eletropositividade	eletropositividade
eletropositivo/electropositivo	eletropositivo	eletropositivo
eletroquímica/electroquímica	eletroquímica	eletroquímica
eletroquímico/electroquímico	eletroquímico	eletroquímico
eletrorradiologia/electrorradiologia	eletrorradiologia	eletrorradiologia
eletrorradiologista/electrorradiologista	eletrorradiologista	eletrorradiologista
eletroscopia/electroscopia	eletroscopia	eletroscopia
eletroscópico/electroscópico	eletroscópico	eletroscópico
eletroscópio/electroscópio	eletroscópio	eletroscópio
eletrossemáforo/electrossemáforo	eletrossemáforo	eletrossemáforo
eletrosserra/electrosserra	eletrosserra	eletrosserra
eletrossiderurgia/electrossiderurgia	eletrossiderurgia	eletrossiderurgia
eletrossiderúrgico/electrossiderúrgico	eletrossiderúrgico	eletrossiderúrgico
eletrossoldadura/electrossoldadura	eletrossoldadura	eletrossoldadura
eletrostática/electrostática	eletrostática	eletrostática
eletrostático/electrostático	eletrostático	eletrostático
eletrostrição/electrostrição	eletrostrição	eletrostrição
eletrotanásia/electrotanásia	eletrotanásia	eletrotanásia
eletrotecnia/electrotecnia	eletrotecnia	eletrotecnia
eletrotécnica/electrotécnica	eletrotécnica	eletrotécnica
eletrotécnico/electrotécnico	eletrotécnico	eletrotécnico
eletroterapeuta/electroterapeuta	eletroterapeuta	eletroterapeuta
eletroterapêutica/electroterapêutica	eletroterapêutica	eletroterapêutica
eletroterapêutico/electroterapêutico	eletroterapêutico	eletroterapêutico
eletroterapia/electroterapia	eletroterapia	eletroterapia
eletroterápico/electroterápico	eletroterápico	eletroterápico
eletrotermia/electrotermia	eletrotermia	eletrotermia
eletrotérmico/electrotérmico	eletrotérmico	eletrotérmico
eletrotipia/electrotipia	eletrotipia	eletrotipia
eletrotípico/electrotípico	eletrotípico	eletrotípico
eletrótipo/electrótipo	eletrótipo	eletrótipo
eletrotropia/electrotropia	eletrotropia	eletrotropia
eletrotrópico/electrotrópico	eletrotrópico	eletrotrópico
eletrotropismo/electrotropismo	eletrotropismo	eletrotropismo
eletrovalência/electrovalência	eletrovalência	eletrovalência
eletrovalente/electrovalente	eletrovalente	eletrovalente
eletrovital/electrovital	eletrovital	eletrovital
eletrovitalismo/electrovitalismo	eletrovitalismo	eletrovitalismo
enguia-elétrica/enguia-eléctrica	enguia-elétrica	enguia-elétrica
epilética/epiléptica	epiléptica	epilética
epilética/epiléptica	epilética	epilética
epilético/epiléptico	epiléptico	epilético
epilético/epiléptico	epilético	epilético
eretamente/erectamente	eretamente	eretamente
eretida/erectida	eretida	eretida
ereto/erecto	ereto	ereto
eretor/erector	eretor	eretor
esmético/esméctico	esmético	esmético
esplenenfrático/esplenenfráctico	esplenenfrático	esplenenfrático
esplenenfrático/esplenenfráctico	esplenenfráctico	esplenenfrático
esplenopético/esplenopéctico	esplenopéctico	esplenopético
esplenopético/esplenopéctico	esplenopético	esplenopético
estupefação/estupefacção	estupefação	estupefação
estupefator/estupefactor	estupefator	estupefator
eurocética/eurocéptica	eurocética	eurocética
euroceticismo/eurocepticismo	euroceticismo	euroceticismo
eurocético/eurocéptico	eurocético	eurocético
eurotimismo/europtimismo	eurotimismo	eurotimismo
eutático/eutáctico	eutático	eutático
exator/exactor	exator	exator
excecional/excepcional	excepcional	excecional
excecionalidade/excepcionalidade	excepcionalidade	excecionalidade
excecionalmente/excepcionalmente	excepcionalmente	excecionalmente
excecionar/excepcionar	excepcionar	excecionar
exceta/excepta	excepta	exceta
exceta/excepta	exceta	exceta
excetivo/exceptivo	excetivo	excetivo
exceto/excepto	exceto	exceto
excetuador/exceptuador	excetuador	excetuador
excetuar/exceptuar	excetuar	excetuar
excetuável/exceptuável	excetuável	excetuável
expetoração/expectoração	expectoração	expetoração
expetorante/expectorante	expectorante	expetorante
expetorar/expectorar	expectorar	expetorar
expetorar/expectorar	expetorar	expetorar
extratar/extractar	extratar	extratar
extrativo/extractivo	extrativo	extrativo
extrato/extracto	extrato	extrato
extrator/extractor	extrator	extrator
extratora/extractora	extratora	extratora
extrojeção/extrojecção	extrojeção	extrojeção
extrospeção/extrospecção	extrospecção	extrospeção
extrospetivo/extrospectivo	extrospectivo	extrospetivo
fação/facção	fação	fação
fator/factor	fator	fator
fator-chave/factor-chave	fator-chave	fator-chave
fatorial/factorial	fatorial	fatorial
fatorizar/factorizar	fatorizar	fatorizar
fatura/factura	fatura	fatura
ferrielétrico/ferrieléctrico	ferrielétrico	ferrielétrico
ferroelétrico/ferroeléctrico	ferroelétrico	ferroelétrico
filotático/filotáctico	filotáctico	filotático
filotático/filotáctico	filotático	filotático
flebopético/flebopéctico	flebopético	flebopético
fletido/flectido	flectido	fletido
fletido/flectido	fletido	fletido
fletir/flectir	flectir	fletir
fletir/flectir	fletir	fletir
fletor/flector	flector	fletor
fletor/flector	fletor	fletor
fonético-sintaticamente/fonético-sintacticamente	fonético-sintaticamente	fonético-sintaticamente
fonético-sintático/fonético-sintáctico	fonético-sintático	fonético-sintático
fotelétrico/foteléctrico	fotelétrico	fotelétrico
fotodielétrico/fotodieléctrico	fotodielétrico	fotodielétrico
fotoeletrão/fotoelectrão	fotoeletrão	fotoeletrão
fotoelétrico/fotoeléctrico	fotoelétrico	fotoelétrico
fotótico/fotóptico	fotótico	fotótico
fototático/fototáctico	fototáctico	fototático
fototático/fototáctico	fototático	fototático
fração/fracção	fração	fração
fracionamento/fraccionamento	fracionamento	fracionamento
fracionar/fraccionar	fracionar	fracionar
fracionário/fraccionário	fracionário	fracionário
fracionável/fraccionável	fracionável	fracionável
fraciúncula/fracciúncula	fraciúncula	fraciúncula
fratura/fractura	fratura	fratura
fraturamento/fracturamento	fraturamento	fraturamento
fraturar/fracturar	fraturar	fraturar
galvanotático/galvanotáctico	galvanotático	galvanotático
gastropético/gastropéctico	gastropéctico	gastropético
gastropético/gastropéctico	gastropético	gastropético
genufletir/genuflectir	genuflectir	genufletir
genufletir/genuflectir	genufletir	genufletir
genufletor/genuflector	genuflector	genuflector
genufletor/genuflector	genufletor	genufletor
genufletora/genuflectora	genuflectora	genufletora
genufletora/genuflectora	genufletora	genufletora
geotático/geotáctico	geotático	geotático
haptotático/haptoctático	haptotático	haptotático
heliotatismo/heliotactismo	heliotactismo	heliotatismo
heliotatismo/heliotactismo	heliotatismo	heliotatismo
hemiatático/hemiatáctico	hemiatático	hemiatático
hemotético/hemotéctico	hemotético	hemotético
hepatopético/hepatopéctico	hepatopético	hepatopético
heteroinfeção/heteroinfecção	heteroinfecção	heteroinfeção
heterorrético/heterorréctico	heterorrético	heterorrético
heterotático/heterotáctico	heterotáctico	heterotático
heterotático/heterotáctico	heterotático	heterotático
hidrelétrico/hidreléctrico	hidrelétrico	hidrelétrico
hidroelétrica/hidroeléctrica	hidroelétrica	hidroelétrica
hidroelétrico/hidroeléctrico	hidroelétrico	hidroelétrico
hidroextrator/hidroextractor	hidroextrator	hidroextrator
hidrofrático/hidrofráctico	hidrofrático	hidrofrático
hipercatalético/hipercataléctico	hipercataléctico	hipercatalético
hipercatalético/hipercataléctico	hipercatalético	hipercatalético
hipercataleto/hipercatalecto	hipercataleto	hipercataleto
hiperdialético/hiperdialéctico	hiperdialético	hiperdialético
hipereutético/hipereutéctico	hipereutético	hipereutético
hipeutético/hipeutéctico	hipeutético	hipeutético
hipotático/hipotáctico	hipotático	hipotático
histeropético/histeropéctico	histeropético	histeropético
holantártico/holantárctico	holantárctico	holantártico
holantártico/holantárctico	holantártico	holantártico
holárctico/holárctico	holárctico	holárctico
homeocatalético/homeocataléctico	homeocatalético	homeocatalético
homeocataleto/homeocatalecto	homeocatalecto	homeocataleto
homeocataleto/homeocatalecto	homeocataleto	homeocataleto
idielétrico/idieléctrico	idielétrico	idielétrico
idioelétrico/idioeléctrico	idioelétrico	idioelétrico
idioleto/idiolecto	idioleto	idioleto
imputrefação/imputrefacção	imputrefação	imputrefação
imunoeletroforese/imunoelectroforese	imunoeletroforese	imunoeletroforese
inefetivo/inefectivo	inefetivo	inefetivo
infeção/infecção	infecção	infeção
infeciologia/infecciologia	infecciologia	infeciologia
infeciologista/infecciologista	infecciologista	infeciologista
infecionado/infeccionado	infeccionado	infecionado
infecionar/infeccionar	infeccionar	infecionar
infecioso/infeccioso	infeccioso	infecioso
infetada/infectada	infectada	infetada
infetado/infectado	infectado	infetado
infetante/infectante	infectante	infetante
infetar/infectar	infectar	infetar
infetável/infectável	infectável	infetável
infetologia/infectologia	infectologia	infetologia
infetológico/infectológico	infectológico	infetológico
infetuosidade/infectuosidade	infectuosidade	infetuosidade
infletir/inflectir	inflectir	infletir
infletir/inflectir	infletir	infletir
inflição/inflicção	inflicção	inflição
inflição/inflicção	inflição	inflição
infração/infracção	infração	infração
infrator/infractor	infrator	infrator
infratora/infractora	infratora	infratora
injetivo/injectivo	injetivo	injetivo
injeto/injecto	injeto	injeto
injetor/injector	injetor	injetor
inobjetividade/inobjectividade	inobjetividade	inobjetividade
inopético/inopéctico	inopético	inopético
inseticida/insecticida	inseticida	inseticida
inseticídio/insecticídio	inseticídio	inseticídio
inseto/insecto	inseto	inseto
inspetivo/inspectivo	inspetivo	inspetivo
insurrecionado/insurreccionado	insurrecionado	insurrecionado
insurrecional/insurreccional	insurrecional	insurrecional
insurrecionalmente/insurreccionalmente	insurrecionalmente	insurrecionalmente
insurrecionar/insurreccionar	insurrecionar	insurrecionar
insurrecionário/insurreccionário	insurrecionário	insurrecionário
insurrecionável/insurreccionável	insurrecionável	insurrecionável
insurrecionismo/insurreccionismo	insurrecionismo	insurrecionismo
insurreccionista/insurreccionista	insurreccionista	insurreccionista
insurreta/insurrecta	insurrecta	insurreta
insurreta/insurrecta	insurreta	insurreta
insurreto/insurrecto	insurrecto	insurreto
insurreto/insurrecto	insurreto	insurreto
insuscetível/insusceptível	insuscetível	insuscetível
interjecional/interjeccional	interjecional	interjecional
interjecionar/interjeccionar	interjecionar	interjecionar
interjetivamente/interjectivamente	interjetivamente	interjetivamente
interjetivo/interjectivo	interjetivo	interjetivo
introjeção/introjecção	introjeção	introjeção
introspeção/introspecção	introspecção	introspeção
introspetivo/introspectivo	introspectivo	introspetivo
intuspeção/intuspecção	intuspecção	intuspeção
intuspeção/intuspecção	intuspeção	intuspeção
intuspetivo/intuspectivo	intuspetivo	intuspetivo
intuspetivo/intuspectivo	intuspectivo	intuspetivo
invetiva/invectiva	invectiva	invetiva
invetiva/invectiva	invectiva	invetiva
invetivador/invectivador	invectivador	invetivador
invetivador/invectivador	invetivador	invetivador
invetivante/invectivante	invectivante	invetivante
invetivante/invectivante	invetivante	invetivante
invetivar/invectivar	invectivar	invetivar
invetivar/invectivar	invetivar	invetivar
invetivista/invectivista	invectivista	invetivista
invetivista/invectivista	invetivista	invetivista
invetivo/invectivo	invectivo	invetivo
invetivo/invectivo	invetivo	invetivo
iselétrico/iseléctrico	iselétrico	iselétrico
isoelétrico/isoeléctrico	isoelétrico	isoelétrico
jato/jacto	jato	jato
jatoplanador/jactoplanador	jatoplanador	jatoplanador
lecionação/leccionação	lecionação	lecionação
lecionador/leccionador	lecionador	lecionador
lecionando/leccionando	lecionando	lecionando
lecionar/leccionar	lecionar	lecionar
lecionário/leccionário	lecionário	lecionário
lecionável/leccionável	lecionável	lecionável
lecionista/leccionista	lecionista	lecionista
letivo/lectivo	letivo	letivo
liquefação/liquefacção	liquefação	liquefação
liquefacto/liquefato	liquefato	liquefacto
liquefator/liquefactor	liquefator	liquefator
magnetelétrico/magneteléctrico	magnetelétrico	magnetelétrico
malático/maláctico	maláctico	malático
malático/maláctico	malático	malático
manufator/manufactor	manufator	manufator
manufatora/manufactora	manufatora	manufatora
manufatura/manufactura	manufatura	manufatura
manufaturação/manufacturação	manufaturação	manufaturação
manufaturado/manufacturado	manufaturado	manufaturado
manufaturador/manufacturador	manufaturador	manufaturador
manufaturar/manufacturar	manufaturar	manufaturar
manufaturável/manufacturável	manufaturável	manufaturável
manufatureiro/manufactureiro	manufatureiro	manufatureiro
mesorreto/mesorrecto	mesorreto	mesorreto
metalético/metaléptico	metaléptico	metalético
metalético/metaléptico	metalético	metalético
metapético/metapéctico	metapético	metapético
microbjetiva/microbjectiva	microbjetiva	microbjetiva
mórfico-sintático/mórfico-sintáctico	mórfico-sintático	mórfico-sintático
morfossintático/morfossintáctico	morfossintático	morfossintático
multidirecional/multidireccional	multidirecional	multidirecional
multifatorial/multifactorial	multifatorial	multifatorial
nefropético/nefropéctico	nefropéctico	nefropético
nefropético/nefropéctico	nefropético	nefropético
obduto/obducto	obduto	obduto
objeção/objecção	objeção	objeção
objetado/objectado	objetado	objetado
objetal/objectal	objetal	objetal
objetante/objectante	objetante	objetante
objetar/objectar	objetar	objetar
objetável/objectável	objetável	objetável
objetiva/objectiva	objetiva	objetiva
objetivação/objectivação	objetivação	objetivação
objetivado/objectivado	objetivado	objetivado
objetivador/objectivador	objetivador	objetivador
objetivamente/objectivamente	objetivamente	objetivamente
objetivar/objectivar	objetivar	objetivar
objetivável/objectivável	objetivável	objetivável
objetividade/objectividade	objetividade	objetividade
objetivismo/objectivismo	objetivismo	objetivismo
objetivista/objectivista	objetivista	objetivista
objetivo/objectivo	objetivo	objetivo
objetologia/objectologia	objectologia	objetologia
objetologia/objectologia	objetologia	objetologia
objetológico/objectológico	objectológico	objetológico
objetológico/objectológico	objetológico	objetológico
objetologista/objectologista	objectologista	objetologista
objetologista/objectologista	objetologista	objetologista
objetólogo/objectólogo	objectólogo	objetólogo
objetólogo/objectólogo	objetólogo	objetólogo
objetor/objector	objetor	objetor
objetora/objectora	objetora	objetora
otávia/octávia	octávia	otávia
otávia/octávia	otávia	otávia
olfatar/olfactar	olfatar	olfatar
olfática/olfáctica	olfática	olfática
olfático/olfáctico	olfático	olfático
olfativamente/olfactivamente	olfativamente	olfativamente
olfativo/olfactivo	olfativo	olfativo
olfato/olfacto	olfato	olfato
olfatometria/olfactometria	olfatometria	olfatometria
olfatométrico/olfactométrico	olfatométrico	olfatométrico
olfatório/olfactório	olfatório	olfatório
omnidirecional/onidirecional	onidirecional	omnidirecional
omnilingue/onilingue	onilingue	omnilingue
ótica/óptica	óptica	ótica
ótica/óptica	ótica	ótica
oticista/opticista	opticista	oticista
oticista/opticista	oticista	oticista
ótico/óptico	óptico	ótico
ótico/óptico	ótico	ótico
otimamente/optimamente	otimamente	otimamente
otimismo/optimismo	otimismo	otimismo
otimista/optimista	otimista	otimista
otimístico/optimístico	otimístico	otimístico
otimização/optimização	otimização	otimização
otimizar/optimizar	otimizar	otimizar
ótimo/óptimo	ótimo	ótimo
organolético/organoléptico	organoléptico	organolético
organolético/organoléptico	organolético	organolético
organotático/organotáctico	organotáctico	organotático
organotático/organotáctico	organotático	organotático
orquiopético/orquiopéctico	orquiopéctico	orquiopético
orquiopético/orquiopéctico	orquiopético	orquiopético
paleártica/paleárctica	paleártica	paleártica
paleártico/paleárctico	paleártico	paleártico
paraelétrico/paraeléctrico	paraelétrico	paraelétrico
paralático/paraláctico	paraláctico	paralático
paralático/paraláctico	paralático	paralático
paralético/paraléctico	paraléctico	paralético
paralético/paraléctico	paralético	paralético
parapético/parapéctico	parapéctico	parapético
parapético/parapéctico	parapético	parapético
paraplético/parapléctico	paraplético	paraplético
parapoplético/parapopléctico	parapoplético	parapoplético
paratático/paractático	paratático	paratático
parelétrico/pareléctrico	parelétrico	parelétrico
parótico/paróptico	parótico	parótico
peixe-elétrico/peixe-eléctrico	peixe-elétrico	peixe-elétrico
perspético/perspéctico	perspéctico	perspético
perspético/perspéctico	perspético	perspético
perspetiva/perspectiva	perspectiva	perspetiva
perspetivação/perspectivação	perspectivação	perspetivação
perspetival/perspectival	perspectival	perspetival
perspetivar/perspectivar	perspectivar	perspetivar
perspetividade/perspectividade	perspectividade	perspetividade
perspetivismo/perspectivismo	perspectivismo	perspetivismo
perspetivista/perspectivista	perspectivista	perspetivista
perspetivístico/perspectivístico	perspectivístico	perspetivístico
perspetivo/perspectivo	perspectivo	perspetivo
perspetográfico/perspectográfico	perspectográfico	perspetográfico
perspetográfico/perspectográfico	perspetográfico	perspetográfico
perspetógrafo/perspectógrafo	perspectógrafo	perspetógrafo
perspetógrafo/perspectógrafo	perspetógrafo	perspetógrafo
piezelétrico/piezeléctrico	piezelétrico	piezelétrico
piezoelétrico/piezoeléctrico	piezoelétrico	piezoelétrico
pirelétrico/pireléctrico	pirelétrico	pirelétrico
piroelétrico/piroeléctrico	piroelétrico	piroelétrico
pneumopético/pneumopéctico	pneumopético	pneumopético
pneumoplético/pneumopléctico	pneumoplético	pneumoplético
pré-adoção/pré-adopção	pré-adoção	pré-adoção
pré-objetal/pré-objectal	pré-objetal	pré-objetal
procatalético/procataléptico	procataléptico	procatalético
procatalético/procataléptico	procatalético	procatalético
proctopético/proctopéctico	proctopéctico	proctopético
proctopético/proctopéctico	proctopético	proctopético
profilaticamente/profilacticamente	profilaticamente	profilaticamente
profilático/profiláctico	profilático	profilático
profilatismo/profilactismo	profilatismo	profilatismo
prolético/proléctico	proléctico	prolético
prolético/proléctico	prolético	prolético
proleticamente/prolepticamente	prolepticamente	proleticamente
proleticamente/prolepticamente	proleticamente	proleticamente
prospetar/prospectar	prospectar	prospetar
prospetiva/prospectiva	prospectiva	prospetiva
prospetivo/prospectivo	prospectivo	prospetivo
prospeto/prospecto	prospecto	prospeto
prospetor/prospector	prospector	prospetor
prospetora/prospectora	prospectora	prospetora
prostatopético/prostatopéctico	prostatopético	prostatopético
pseudodialetal/pseudodialectal	pseudodialetal	pseudodialetal
punctiforme/puntiforme	puntiforme	punctiforme
putrefação/putrefacção	putrefação	putrefação
putrefator/putrefactor	putrefator	putrefator
putrefatório/putrefactório	putrefatório	putrefatório
quimiotático/quimiotáctico	quimiotáctico	quimiotático
quimiotático/quimiotáctico	quimiotático	quimiotático
radielétrico/radieléctrico	radielétrico	radielétrico
radioelétrico/radioeléctrico	radioelétrico	radioelétrico
rarefação/rarefacção	rarefação	rarefação
rarefator/rarefactor	rarefator	rarefator
readoção/readopção	readoção	readoção
readotar/readoptar	readotar	readotar
rebatismo/rebaptismo	rebatismo	rebatismo
recoleta/recolecta	recoleta	recoleta
recoleto/recolecto	recoleto	recoleto
retangular/rectangular	retangular	retangular
retangularidade/rectangularidade	retangularidade	retangularidade
retangularmente/rectangularmente	retangularmente	retangularmente
retângulo/rectângulo	retângulo	retângulo
reticórneo/recticórneo	reticórneo	reticórneo
retidão/rectidão	retidão	retidão
retificação/rectificação	retificação	retificação
retificador/rectificador	retificador	retificador
retificar/rectificar	retificar	retificar
retificativo/rectificativo	retificativo	retificativo
retificável/rectificável	retificável	retificável
retifloro/rectifloro	retifloro	retifloro
retiforme/rectiforme	retiforme	retiforme
retígrado/rectígrado	retígrado	retígrado
retilineamente/rectilineamente	retilineamente	retilineamente
retilinearidade/rectilinearidade	retilinearidade	retilinearidade
retilíneo/rectilíneo	retilíneo	retilíneo
retinérveo/rectinérveo	retinérveo	retinérveo
retiparalelinérveo/rectiparalelinérveo	retiparalelinérveo	retiparalelinérveo
retirrostro/rectirrostro	rectirrostro	retirrostro
retirrostro/rectirrostro	retirrostro	retirrostro
retite/rectite	rectite	retite
retite/rectite	retite	retite
retitude/rectitude	retitude	retitude
reto/recto	reto	reto
retouretral/rectouretral	retouretral	retouretral
retocele/rectocele	retocele	retocele
retococcígeo/rectococcígeo	retococcígeo	retococcígeo
retocolite/rectocolite	retocolite	retocolite
retopético/rectopéctico	retopético	retopético
retopexia/rectopexia	retopexia	retopexia
retor/rector	retor	retor
retoscopia/rectoscopia	retoscopia	retoscopia
retoscópico/rectoscópico	retoscópico	retoscópico
retoscópio/rectoscópio	retoscópio	retoscópio
retotomia/rectotomia	retotomia	retotomia
retovaginal/rectovaginal	retovaginal	retovaginal
retovesical/rectovesical	retovesical	retovesical
retriz/rectriz	retriz	retriz
returetral/recturetral	returetral	returetral
refletido/reflectido	refletido	refletido
refletividade/reflectividade	refletividade	refletividade
refração/refracção	refração	refração
refratar/refractar	refratar	refratar
refratariamente/refractariamente	refratariamente	refratariamente
refratário/refractário	refratário	refratário
refratarismo/refractarismo	refratarismo	refratarismo
refratividade/refractividade	refratividade	refratividade
refrativo/refractivo	refrativo	refrativo
refrato/refracto	refrato	refrato
refrator/refractor	refrator	refrator
refratoscópico/refractoscópico	refratoscópico	refratoscópico
refratoscópio/refractoscópio	refratoscópio	refratoscópio
regioletal/regiolectal	regioletal	regioletal
regioleto/regiolecto	regioleto	regioleto
reinfeção/reinfecção	reinfecção	reinfeção
reinfecionar/reinfeccionar	reinfeccionar	reinfecionar
reotático/reotáctico	reotáctico	reotático
reotático/reotáctico	reotático	reotático
respetivamente/respectivamente	respectivamente	respetivamente
respetivo/respectivo	respectivo	respetivo
ressurrecional/ressurreccional	ressurreccional	ressurrecional
ressurrecional/ressurreccional	ressurrecional	ressurrecional
ressurrecionismo/ressurreccionismo	ressurreccionismo	ressurrecionismo
ressurrecionismo/ressurreccionismo	ressurrecionismo	ressurrecionismo
ressurrecionista/ressurreccionista	ressurreccionista	ressurrecionista
ressurrecionista/ressurreccionista	ressurrecionista	ressurrecionista
ressurreto/ressurrecto	ressurrecto	ressurreto
ressurreto/ressurrecto	ressurreto	ressurreto
retrofletido/retroflectido	retrofletido	retrofletido
retrofletir/retroflectir	retrofletir	retrofletir
retrospeção/retrospecção	retrospecção	retrospeção
retrospetiva/retrospectiva	retrospectiva	retrospetiva
retrospetivamente/retrospectivamente	retrospectivamente	retrospetivamente
retrospetividade/retrospectividade	retrospectividade	retrospetividade
retrospetivo/retrospectivo	retrospectivo	retrospetivo
retrospeto/retrospecto	retrospecto	retrospeto
riciácea/ricciácea	ricciácea	riciácea
riciácea/ricciácea	riciácea	riciácea
rinenfrático/rinenfráctico	rinenfráctico	rinenfrático
rinenfrático/rinenfráctico	rinenfrático	rinenfrático
rizotático/rizotáctico	rizotáctico	rizotático
rizotático/rizotáctico	rizotático	rizotático
simplético/simpléctico	simplético	simplético
sintaticamente/sintacticamente	sintaticamente	sintaticamente
sintaticista/sintacticista	sintaticista	sintaticista
sintático/sintáctico	sintático	sintático
socioletal/sociolectal	socioletal	socioletal
socioleto/sociolecto	socioleto	socioleto
subártico/subárctico	subártico	subártico
subdialetal/subdialectal	subdialetal	subdialetal
subdialeto/subdialecto	subdialeto	subdialeto
subjeção/subjecção	subjeção	subjeção
superinfeção/superinfecção	superinfecção	superinfeção
suscetibilidade/susceptibilidade	suscetibilidade	suscetibilidade
suscetibilizar/susceptibilizar	suscetibilizar	suscetibilizar
suscetível/susceptível	suscetível	suscetível
tateabilidade/tacteabilidade	tateabilidade	tateabilidade
tateadamente/tacteadamente	tateadamente	tateadamente
tateamento/tacteamento	tateamento	tateamento
tateante/tacteante	tateante	tateante
tatear/tactear	tatear	tatear
tateável/tacteável	tateável	tateável
tateio/tacteio	tateio	tateio
tática/táctica	tática	tática
taticamente/tacticamente	taticamente	taticamente
tático/táctico	tático	tático
tato/tacto	tato	tato
técnico-tático/técnico-táctico	técnico-tático	técnico-tático
tecnoletal/tecnolectal	tecnoletal	tecnoletal
tecnoleto/tecnolecto	tecnoleto	tecnoleto
teto/tecto	teto	teto
teleobjetiva/teleobjectiva	teleobjetiva	teleobjetiva
telobjetiva/telobjectiva	telobjetiva	telobjetiva
telótico/telóptico	telóptico	telótico
telótico/telóptico	telótico	telótico
tenontopético/tenontopéctico	tenontopético	tenontopético
tenopético/tenopéctico	tenopético	tenopético
termelétrico/termeléctrico	termelétrico	termelétrico
termodielétrico/termodieléctrico	termodielétrico	termodielétrico
termoelétrico/termoeléctrico	termoelétrico	termoelétrico
termotático/termotáctico	termotático	termotático
tiflopético/tiflopéctico	tiflopéctico	tiflopético
tiflopético/tiflopéctico	tiflopético	tiflopético
tigmotático/tigmotáctico	tigmotático	tigmotático
torrefação/torrefacção	torrefação	torrefação
torrefator/torrefactor	torrefator	torrefator
tratório/tractório	tratório	tratório
transato/transacto	transato	transato
transator/transactor	transator	transator
transobjetivo/transobjectivo	transobjetivo	transobjetivo
traquelopético/traquelopéctico	traquelopético	traquelopético
triboelétrico/triboeléctrico	triboelétrico	triboelétrico
tricorrético/tricorréctico	tricorréctico	tricorrético
tricorrético/tricorréctico	tricorrético	tricorrético
tumefação/tumefacção	tumefação	tumefação
ureterenfrático/ureterenfráctico	ureterenfrático	ureterenfrático
uretrofrático/uretrofráctico	uretrofrático	uretrofrático
vetação/vectação	vetação	vetação
vetor/vector	vetor	vetor
vetorial/vectorial	vetorial	vetorial
vetorizar/vectorizar	vetorizar	vetorizar
vice-coletor/vice-colector	vice-coletor	vice-coletor
zigotático/zigotáctico	zigotático	zigotático
zoelétrico/zoeléctrico	zoelétrico	zoelétrico
zooelétrico/zooeléctrico	zooelétrico	zooelétrico
zoótico/zoóptico	zoóptico	zoótico
zoótico/zoóptico	zoótico	zoótico
zootático/zootáctico	zootático	zootático
