ab-repticiamente	ab-repticiamente	RG
abacalhoadamente	abacalhoadamente	RG
abafadamente	abafadamente	RG
abalizadamente	abalizadamente	RG
abandalhadamente	abandalhadamente	RG
abandonadamente	abandonadamente	RG
abastadamente	abastadamente	RG
abastardadamente	abastardadamente	RG
abastosamente	abastosamente	RG
abatidamente	abatidamente	RG
abauladamente	abauladamente	RG
abdicativamente	abdicativamente	RG
abditivamente	abditivamente	RG
abeatadamente	abeatadamente	RG
abecedariamente	abecedariamente	RG
abelhudamente	abelhudamente	RG
abemoladamente	abemoladamente	RG
abençoadamente	abençoadamente	RG
aberrativamente	aberrativamente	RG
aberratoriamente	aberratoriamente	RG
abertamente	abertamente	RG
abespinhadamente	abespinhadamente	RG
abjectamente	abjectamente	RG
abjetamente	abjetamente	RG
abnegadamente	abnegadamente	RG
abominavelmente	abominavelmente	RG
abominosamente	abominosamente	RG
abonadamente	abonadamente	RG
abonativamente	abonativamente	RG
abonatoriamente	abonatoriamente	RG
abonecadamente	abonecadamente	RG
aborrecidamente	aborrecidamente	RG
aborrecivelmente	aborrecivelmente	RG
aborridamente	aborridamente	RG
abortivamente	abortivamente	RG
abrasadamente	abrasadamente	RG
abrasadoramente	abrasadoramente	RG
abrasileiradamente	abrasileiradamente	RG
abrejeiradamente	abrejeiradamente	RG
abreviadamente	abreviadamente	RG
abreviativamente	abreviativamente	RG
abrigadamente	abrigadamente	RG
abruptamente	abruptamente	RG
abrutadamente	abrutadamente	RG
abrutalhadamente	abrutalhadamente	RG
absolutamente	absolutamente	RG
absorventemente	absorventemente	RG
abstemicamente	abstemicamente	RG
abstinentemente	abstinentemente	RG
abstraidamente	abstraidamente	RG
abstratamente	abstratamente	RG
abstrativamente	abstrativamente	RG
abstrusamente	abstrusamente	RG
absurdamente	absurdamente	RG
abulicamente	abulicamente	RG
abundantemente	abundantemente	RG
abundosamente	abundosamente	RG
abusadamente	abusadamente	RG
abusivamente	abusivamente	RG
acabadamente	acabadamente	RG
acabrunhadamente	acabrunhadamente	RG
acachapadamente	acachapadamente	RG
acacianamente	acacianamente	RG
academialmente	academialmente	RG
academicamente	academicamente	RG
acaloradamente	acaloradamente	RG
acambaiadamente	acambaiadamente	RG
acanalhadamente	acanalhadamente	RG
acanhadamente	acanhadamente	RG
acanhotadamente	acanhotadamente	RG
acanonicamente	acanonicamente	RG
acasteladamente	acasteladamente	RG
acauteladamente	acauteladamente	RG
acavaladamente	acavaladamente	RG
acaçapadamente	acaçapadamente	RG
aceitavelmente	aceitavelmente	RG
aceitosamente	aceitosamente	RG
aceleradamente	aceleradamente	RG
acendradamente	acendradamente	RG
acentuadamente	acentuadamente	RG
aceradamente	aceradamente	RG
acerbamente	acerbamente	RG
acerrimamente	acerrimamente	RG
acertadamente	acertadamente	RG
acesamente	acesamente	RG
acessivamente	acessivamente	RG
acessivelmente	acessivelmente	RG
acessoriamente	acessoriamente	RG
achaparradamente	achaparradamente	RG
achatadamente	achatadamente	RG
achavascadamente	achavascadamente	RG
achegadamente	achegadamente	RG
acidamente	acidamente	RG
acidentadamente	acidentadamente	RG
acidentalmente	acidentalmente	RG
acidentariamente	acidentariamente	RG
acintosamente	acintosamente	RG
acionadamente	acionadamente	RG
acirradamente	acirradamente	RG
acobardadamente	acobardadamente	RG
acoguladamente	acoguladamente	RG
acolhedoramente	acolhedoramente	RG
acomodadamente	acomodadamente	RG
acomodaticiamente	acomodaticiamente	RG
aconselhavelmente	aconselhavelmente	RG
acordadamente	acordadamente	RG
acordemente	acordemente	RG
acostumadamente	acostumadamente	RG
acovardadamente	acovardadamente	RG
acremente	acremente	RG
acrescentadamente	acrescentadamente	RG
acriançadamente	acriançadamente	RG
acrimoniosamente	acrimoniosamente	RG
acrisoladamente	acrisoladamente	RG
acriticamente	acriticamente	RG
acrobaticamente	acrobaticamente	RG
acromaticamente	acromaticamente	RG
acronicamente	acronicamente	RG
acumulativamente	acumulativamente	RG
acuradamente	acuradamente	RG
acusativamente	acusativamente	RG
acusatoriamente	acusatoriamente	RG
acusticamente	acusticamente	RG
adequadamente	adequadamente	RG
adesivamente	adesivamente	RG
adiantadamente	adiantadamente	RG
adicionalmente	adicionalmente	RG
aditiciamente	aditiciamente	RG
aditivamente	aditivamente	RG
adjetivamente	adjetivamente	RG
administrativamente	administrativamente	RG
admirativamente	admirativamente	RG
admiravelmente	admiravelmente	RG
admissivelmente	admissivelmente	RG
admitidamente	admitidamente	RG
adnominalmente	adnominalmente	RG
adoptivamente	adoptivamente	RG
adorativamente	adorativamente	RG
adoravelmente	adoravelmente	RG
adotivamente	adotivamente	RG
adstritamente	adstritamente	RG
adulativamente	adulativamente	RG
adulatoriamente	adulatoriamente	RG
adulteradamente	adulteradamente	RG
adulteramente	adulteramente	RG
adulterinamente	adulterinamente	RG
adutivamente	adutivamente	RG
adventiciamente	adventiciamente	RG
adverbialmente	adverbialmente	RG
adversamente	adversamente	RG
adversariamente	adversariamente	RG
adversativamente	adversativamente	RG
advertidamente	advertidamente	RG
aereamente	aereamente	RG
afadigadamente	afadigadamente	RG
afamadamente	afamadamente	RG
afanosamente	afanosamente	RG
afavelmente	afavelmente	RG
afeadamente	afeadamente	RG
afectadamente	afectadamente	RG
afectivamente	afectivamente	RG
afectuosamente	afectuosamente	RG
afeiçoadamente	afeiçoadamente	RG
afeminadamente	afeminadamente	RG
aferradamente	aferradamente	RG
aferventadamente	aferventadamente	RG
afervoradamente	afervoradamente	RG
afetadamente	afetadamente	RG
afetivamente	afetivamente	RG
afetuosamente	afetuosamente	RG
afidalgadamente	afidalgadamente	RG
afinadamente	afinadamente	RG
afincadamente	afincadamente	RG
afirmativamente	afirmativamente	RG
aflautadamente	aflautadamente	RG
aflitamente	aflitamente	RG
aflitivamente	aflitivamente	RG
afogadamente	afogadamente	RG
afoitamente	afoitamente	RG
afonicamente	afonicamente	RG
aforisticamente	aforisticamente	RG
aforradamente	aforradamente	RG
afortunadamente	afortunadamente	RG
afoutamente	afoutamente	RG
afragatadamente	afragatadamente	RG
afrancesadamente	afrancesadamente	RG
africanamente	africanamente	RG
afrontadamente	afrontadamente	RG
afrontosamente	afrontosamente	RG
afuniladamente	afuniladamente	RG
agaiatadamente	agaiatadamente	RG
agalegadamente	agalegadamente	RG
agarotadamente	agarotadamente	RG
agastadamente	agastadamente	RG
agenciosamente	agenciosamente	RG
agigantadamente	agigantadamente	RG
agilmente	agilmente	RG
agitadamente	agitadamente	RG
aglomeradamente	aglomeradamente	RG
aglutinadamente	aglutinadamente	RG
agnosticamente	agnosticamente	RG
agoniadamente	agoniadamente	RG
agonisticamente	agonisticamente	RG
agradavelmente	agradavelmente	RG
agremente	agremente	RG
agremiadamente	agremiadamente	RG
agressivamente	agressivamente	RG
agrestemente	agrestemente	RG
agricolamente	agricolamente	RG
agronomicamente	agronomicamente	RG
agudamente	agudamente	RG
aguerridamente	aguerridamente	RG
aguçadamente	aguçadamente	RG
aguçosamente	aguçosamente	RG
airosamente	airosamente	RG
ajeitadamente	ajeitadamente	RG
ajuizadamente	ajuizadamente	RG
ajustadamente	ajustadamente	RG
alambicadamente	alambicadamente	RG
alarvemente	alarvemente	RG
alatinadamente	alatinadamente	RG
alcantiladamente	alcantiladamente	RG
aleatoriamente	aleatoriamente	RG
alegadamente	alegadamente	RG
alegoricamente	alegoricamente	RG
alegremente	alegremente	RG
aleivosamente	aleivosamente	RG
alfabeticamente	alfabeticamente	RG
algebricamente	algebricamente	RG
alheadamente	alheadamente	RG
alheiamente	alheiamente	RG
alienadamente	alienadamente	RG
alinhadamente	alinhadamente	RG
alongadamente	alongadamente	RG
aloucadamente	aloucadamente	RG
altamente	altamente	RG
altaneiramente	altaneiramente	RG
alternadamente	alternadamente	RG
alternamente	alternamente	RG
alternativamente	alternativamente	RG
alterosamente	alterosamente	RG
altissonantemente	altissonantemente	RG
altivamente	altivamente	RG
altruisticamente	altruisticamente	RG
aluadamente	aluadamente	RG
alucinadamente	alucinadamente	RG
alucinantemente	alucinantemente	RG
alusivamente	alusivamente	RG
alvarmente	alvarmente	RG
alveoladamente	alveoladamente	RG
alvinitentemente	alvinitentemente	RG
alvoratadamente	alvoratadamente	RG
alvoraçadamente	alvoraçadamente	RG
alvoreadamente	alvoreadamente	RG
alvoriçadamente	alvoriçadamente	RG
alvorotadamente	alvorotadamente	RG
alvoroçadamente	alvoroçadamente	RG
amacacadamente	amacacadamente	RG
amadoristicamente	amadoristicamente	RG
amadurecidamente	amadurecidamente	RG
amaldiçoadamente	amaldiçoadamente	RG
amancebadamente	amancebadamente	RG
amaneiradamente	amaneiradamente	RG
amaramente	amaramente	RG
amargaduramente	amargaduramente	RG
amargamente	amargamente	RG
amargosamente	amargosamente	RG
amarguradamente	amarguradamente	RG
amaricadamente	amaricadamente	RG
amarradamente	amarradamente	RG
amatoriamente	amatoriamente	RG
amavelmente	amavelmente	RG
amaviosamente	amaviosamente	RG
amazonicamente	amazonicamente	RG
ambiciosamente	ambiciosamente	RG
ambientalmente	ambientalmente	RG
ambiguamente	ambiguamente	RG
ambivalentemente	ambivalentemente	RG
ambulatoriamente	ambulatoriamente	RG
ameaçadoramente	ameaçadoramente	RG
amedrontadoramente	amedrontadoramente	RG
amenamente	amenamente	RG
americanamente	americanamente	RG
amestradamente	amestradamente	RG
ametricamente	ametricamente	RG
amigavelmente	amigavelmente	RG
amimadamente	amimadamente	RG
amistosamente	amistosamente	RG
amiudadamente	amiudadamente	RG
amodorradamente	amodorradamente	RG
amontoadamente	amontoadamente	RG
amoravelmente	amoravelmente	RG
amorosamente	amorosamente	RG
amplamente	amplamente	RG
amuadamente	amuadamente	RG
anacoreticamente	anacoreticamente	RG
anacronicamente	anacronicamente	RG
anaerobiamente	anaerobiamente	RG
anaforicamente	anaforicamente	RG
anagramaticamente	anagramaticamente	RG
analfabeticamente	analfabeticamente	RG
analiticamente	analiticamente	RG
analogamente	analogamente	RG
analogicamente	analogicamente	RG
anarmonicamente	anarmonicamente	RG
anarquicamente	anarquicamente	RG
anastaticamente	anastaticamente	RG
anastroficamente	anastroficamente	RG
anatomicamente	anatomicamente	RG
ancestralmente	ancestralmente	RG
andrajosamente	andrajosamente	RG
anedoticamente	anedoticamente	RG
anfibologicamente	anfibologicamente	RG
anfiguricamente	anfiguricamente	RG
anfiguriticamente	anfiguriticamente	RG
angelicalmente	angelicalmente	RG
angelicamente	angelicamente	RG
anglicanamente	anglicanamente	RG
angustiadamente	angustiadamente	RG
angustiosamente	angustiosamente	RG
animadamente	animadamente	RG
animalmente	animalmente	RG
animicamente	animicamente	RG
animosamente	animosamente	RG
anomalamente	anomalamente	RG
anonimamente	anonimamente	RG
anormalmente	anormalmente	RG
ansiadamente	ansiadamente	RG
ansiosamente	ansiosamente	RG
antagonicamente	antagonicamente	RG
antecedentemente	antecedentemente	RG
antecipadamente	antecipadamente	RG
anteriormente	anteriormente	RG
anti-higienicamente	anti-higienicamente	RG
anti-infecciosamente	anti-infecciosamente	RG
anti-infeciosamente	anti-infeciosamente	RG
antiaristocraticamente	antiaristocraticamente	RG
anticonstitucionalmente	anticonstitucionalmente	RG
antidemocraticamente	antidemocraticamente	RG
antidesportivamente	antidesportivamente	RG
antifrasticamente	antifrasticamente	RG
antigamente	antigamente	RG
antiguamente	antiguamente	RG
antimelodicamente	antimelodicamente	RG
antinomicamente	antinomicamente	RG
antipaticamente	antipaticamente	RG
antipatrioticamente	antipatrioticamente	RG
antiteticamente	antiteticamente	RG
antologicamente	antologicamente	RG
antonimicamente	antonimicamente	RG
antonomasticamente	antonomasticamente	RG
antropologicamente	antropologicamente	RG
antropometricamente	antropometricamente	RG
antropomorficamente	antropomorficamente	RG
antroponimicamente	antroponimicamente	RG
anualmente	anualmente	RG
aoristicamente	aoristicamente	RG
apagadamente	apagadamente	RG
apaixonadamente	apaixonadamente	RG
apalermadamente	apalermadamente	RG
apalhaçadamente	apalhaçadamente	RG
aparatosamente	aparatosamente	RG
aparentemente	aparentemente	RG
apartadamente	apartadamente	RG
aparvalhadamente	aparvalhadamente	RG
aparvoadamente	aparvoadamente	RG
apaticamente	apaticamente	RG
apavoradamente	apavoradamente	RG
apavoradoramente	apavoradoramente	RG
apaziguadoramente	apaziguadoramente	RG
apegadamente	apegadamente	RG
apelativamente	apelativamente	RG
apelatoriamente	apelatoriamente	RG
aperfeiçoadamente	aperfeiçoadamente	RG
aperreadamente	aperreadamente	RG
apertadamente	apertadamente	RG
apetecidamente	apetecidamente	RG
apetecivelmente	apetecivelmente	RG
apetitosamente	apetitosamente	RG
aplaudidamente	aplaudidamente	RG
aplicadamente	aplicadamente	RG
apocalipticamente	apocalipticamente	RG
apocrifamente	apocrifamente	RG
apofonicamente	apofonicamente	RG
apologeticamente	apologeticamente	RG
apontadamente	apontadamente	RG
apoquentadamente	apoquentadamente	RG
aportuguesadamente	aportuguesadamente	RG
apositamente	apositamente	RG
apositivamente	apositivamente	RG
apostadamente	apostadamente	RG
apostamente	apostamente	RG
apostolicamente	apostolicamente	RG
apoteoticamente	apoteoticamente	RG
apoucadamente	apoucadamente	RG
aprazivelmente	aprazivelmente	RG
apreciativamente	apreciativamente	RG
apreciavelmente	apreciavelmente	RG
apreensivamente	apreensivamente	RG
apresentavelmente	apresentavelmente	RG
apressadamente	apressadamente	RG
apressuradamente	apressuradamente	RG
aprimoradamente	aprimoradamente	RG
aprioristicamente	aprioristicamente	RG
aprobativamente	aprobativamente	RG
aprobatoriamente	aprobatoriamente	RG
aprofundadamente	aprofundadamente	RG
apropositadamente	apropositadamente	RG
apropriadamente	apropriadamente	RG
aprovativamente	aprovativamente	RG
aproveitadamente	aproveitadamente	RG
aproveitavelmente	aproveitavelmente	RG
aproximadamente	aproximadamente	RG
aproximativamente	aproximativamente	RG
aprumadamente	aprumadamente	RG
aptamente	aptamente	RG
apuradamente	apuradamente	RG
aquaticamente	aquaticamente	RG
arbitralmente	arbitralmente	RG
arbitrariamente	arbitrariamente	RG
arcadicamente	arcadicamente	RG
arcaicamente	arcaicamente	RG
ardentemente	ardentemente	RG
ardidamente	ardidamente	RG
ardilosamente	ardilosamente	RG
ardorosamente	ardorosamente	RG
arduamente	arduamente	RG
arguciosamente	arguciosamente	RG
arguitivamente	arguitivamente	RG
argutamente	argutamente	RG
aristocraticamente	aristocraticamente	RG
aristotelicamente	aristotelicamente	RG
aritmeticamente	aritmeticamente	RG
arqueologicamente	arqueologicamente	RG
arquitectonicamente	arquitectonicamente	RG
arquitetonicamente	arquitetonicamente	RG
arquivisticamente	arquivisticamente	RG
arraigadamente	arraigadamente	RG
arrancadamente	arrancadamente	RG
arrastadamente	arrastadamente	RG
arrazoadamente	arrazoadamente	RG
arrebatadamente	arrebatadamente	RG
arrebatadoramente	arrebatadoramente	RG
arrebicadamente	arrebicadamente	RG
arreigadamente	arreigadamente	RG
arremessadamente	arremessadamente	RG
arrevesadamente	arrevesadamente	RG
arriscadamente	arriscadamente	RG
arritmicamente	arritmicamente	RG
arrogantemente	arrogantemente	RG
arrojadamente	arrojadamente	RG
arteiramente	arteiramente	RG
artesanalmente	artesanalmente	RG
articuladamente	articuladamente	RG
articulatoriamente	articulatoriamente	RG
artificialmente	artificialmente	RG
artificiosamente	artificiosamente	RG
artisticamente	artisticamente	RG
ascensionalmente	ascensionalmente	RG
asceticamente	asceticamente	RG
ascorosamente	ascorosamente	RG
asiaticamente	asiaticamente	RG
asnalmente	asnalmente	RG
asnamente	asnamente	RG
asnaticamente	asnaticamente	RG
asperamente	asperamente	RG
asperrimamente	asperrimamente	RG
aspiradamente	aspiradamente	RG
asquerosamente	asquerosamente	RG
assanhadamente	assanhadamente	RG
asseadamente	asseadamente	RG
asselvajadamente	asselvajadamente	RG
assepticamente	assepticamente	RG
assertivamente	assertivamente	RG
asseveradamente	asseveradamente	RG
asseverativamente	asseverativamente	RG
assiduamente	assiduamente	RG
assilabicamente	assilabicamente	RG
assimetricamente	assimetricamente	RG
assinaladamente	assinaladamente	RG
assindeticamente	assindeticamente	RG
assisadamente	assisadamente	RG
assistematicamente	assistematicamente	RG
associadamente	associadamente	RG
associativamente	associativamente	RG
assomadamente	assomadamente	RG
assombrosamente	assombrosamente	RG
assumidamente	assumidamente	RG
assustadoramente	assustadoramente	RG
astrologicamente	astrologicamente	RG
astronomicamente	astronomicamente	RG
astuciosamente	astuciosamente	RG
astutamente	astutamente	RG
atabafadamente	atabafadamente	RG
atabalhoadamente	atabalhoadamente	RG
atarantadamente	atarantadamente	RG
atarefadamente	atarefadamente	RG
atavicamente	atavicamente	RG
atemorizadamente	atemorizadamente	RG
atempadamente	atempadamente	RG
atenciosamente	atenciosamente	RG
atentamente	atentamente	RG
atenuadamente	atenuadamente	RG
aterradamente	aterradamente	RG
atestadamente	atestadamente	RG
atiladamente	atiladamente	RG
atinadamente	atinadamente	RG
ativamente	ativamente	RG
atleticamente	atleticamente	RG
atoamente	atoamente	RG
atoladamente	atoladamente	RG
atoleimadamente	atoleimadamente	RG
atomicamente	atomicamente	RG
atomisticamente	atomisticamente	RG
atonitamente	atonitamente	RG
atordoadamente	atordoadamente	RG
atrabiliariamente	atrabiliariamente	RG
atraentemente	atraentemente	RG
atrapalhadamente	atrapalhadamente	RG
atrasadamente	atrasadamente	RG
atrativamente	atrativamente	RG
atravessadamente	atravessadamente	RG
atrevidamente	atrevidamente	RG
atribuladamente	atribuladamente	RG
atributivamente	atributivamente	RG
atroadoramente	atroadoramente	RG
atropeladamente	atropeladamente	RG
atrozmente	atrozmente	RG
atualmente	atualmente	RG
atuosamente	atuosamente	RG
aturadamente	aturadamente	RG
audaciosamente	audaciosamente	RG
audazmente	audazmente	RG
auditivamente	auditivamente	RG
audivelmente	audivelmente	RG
augustamente	augustamente	RG
aumentativamente	aumentativamente	RG
auspiciosamente	auspiciosamente	RG
austeramente	austeramente	RG
autenticamente	autenticamente	RG
autoclinicamente	autoclinicamente	RG
autocraticamente	autocraticamente	RG
autocriticamente	autocriticamente	RG
autodidaticamente	autodidaticamente	RG
automaticamente	automaticamente	RG
autonomamente	autonomamente	RG
autonomicamente	autonomicamente	RG
autoritariamente	autoritariamente	RG
autorizadamente	autorizadamente	RG
auxiliarmente	auxiliarmente	RG
avantajadamente	avantajadamente	RG
avaramente	avaramente	RG
aventureiramente	aventureiramente	RG
aventurosamente	aventurosamente	RG
avessamente	avessamente	RG
avezadamente	avezadamente	RG
avidamente	avidamente	RG
avisadamente	avisadamente	RG
avondosamente	avondosamente	RG
avulsamente	avulsamente	RG
avultadamente	avultadamente	RG
axialmente	axialmente	RG
axiomaticamente	axiomaticamente	RG
azafamadamente	azafamadamente	RG
azedamente	azedamente	RG
azougadamente	azougadamente	RG
açambarcadoramente	açambarcadoramente	RG
açodadamente	açodadamente	RG
açucaradamente	açucaradamente	RG
bacteriologicamente	bacteriologicamente	RG
baixamente	baixamente	RG
balbuciantemente	balbuciantemente	RG
baldadamente	baldadamente	RG
baldademente	baldademente	RG
banalmente	banalmente	RG
baquicamente	baquicamente	RG
baratamente	baratamente	RG
barbaramente	barbaramente	RG
barometricamente	barometricamente	RG
basicamente	basicamente	RG
basilarmente	basilarmente	RG
bastamente	bastamente	RG
bastantemente	bastantemente	RG
beatamente	beatamente	RG
beatificamente	beatificamente	RG
bebedamente	bebedamente	RG
belamente	belamente	RG
belicamente	belicamente	RG
belicosamente	belicosamente	RG
beligerantemente	beligerantemente	RG
bem-afortunadamente	bem-afortunadamente	RG
bem-aventuradamente	bem-aventuradamente	RG
bem-encaradamente	bem-encaradamente	RG
beneficamente	beneficamente	RG
beneficiosamente	beneficiosamente	RG
benemeritamente	benemeritamente	RG
benevolamente	benevolamente	RG
benevolentemente	benevolentemente	RG
benignamente	benignamente	RG
berrantemente	berrantemente	RG
bestialmente	bestialmente	RG
bianualmente	bianualmente	RG
biblicamente	biblicamente	RG
bibliograficamente	bibliograficamente	RG
bienalmente	bienalmente	RG
bilateralmente	bilateralmente	RG
bimensalmente	bimensalmente	RG
bimestralmente	bimestralmente	RG
binariamente	binariamente	RG
biograficamente	biograficamente	RG
biologicamente	biologicamente	RG
bisonhamente	bisonhamente	RG
bissemanalmente	bissemanalmente	RG
bissemestralmente	bissemestralmente	RG
bissexualmente	bissexualmente	RG
bizarramente	bizarramente	RG
blandiciosamente	blandiciosamente	RG
boamente	boamente	RG
boemiamente	boemiamente	RG
bombasticamente	bombasticamente	RG
bonançosamente	bonançosamente	RG
bondosamente	bondosamente	RG
borbulhantemente	borbulhantemente	RG
botanicamente	botanicamente	RG
brandamente	brandamente	RG
brasileiramente	brasileiramente	RG
brasilicamente	brasilicamente	RG
bravamente	bravamente	RG
braviamente	braviamente	RG
braçalmente	braçalmente	RG
brejeiramente	brejeiramente	RG
brevemente	brevemente	RG
brilhantemente	brilhantemente	RG
briosamente	briosamente	RG
britanicamente	britanicamente	RG
broncamente	broncamente	RG
brumosamente	brumosamente	RG
bruscamente	bruscamente	RG
brutalmente	brutalmente	RG
brutamente	brutamente	RG
bucolicamente	bucolicamente	RG
buliçosamente	buliçosamente	RG
burguesmente	burguesmente	RG
burlescamente	burlescamente	RG
burlosamente	burlosamente	RG
burocraticamente	burocraticamente	RG
cabalisticamente	cabalisticamente	RG
cabalmente	cabalmente	RG
cabotinamente	cabotinamente	RG
cacograficamente	cacograficamente	RG
cacologicamente	cacologicamente	RG
cadavericamente	cadavericamente	RG
cadenciadamente	cadenciadamente	RG
cafrealmente	cafrealmente	RG
calaceiramente	calaceiramente	RG
caladamente	caladamente	RG
calamitosamente	calamitosamente	RG
calidamente	calidamente	RG
caligraficamente	caligraficamente	RG
calmamente	calmamente	RG
calorosamente	calorosamente	RG
caluniosamente	caluniosamente	RG
candidamente	candidamente	RG
canhestramente	canhestramente	RG
caninamente	caninamente	RG
canonicamente	canonicamente	RG
canoramente	canoramente	RG
caoticamente	caoticamente	RG
capazmente	capazmente	RG
capciosamente	capciosamente	RG
capitalmente	capitalmente	RG
capitosamente	capitosamente	RG
capitularmente	capitularmente	RG
caprichosamente	caprichosamente	RG
caqueticamente	caqueticamente	RG
caracteristicamente	caracteristicamente	RG
caranguejalmente	caranguejalmente	RG
carateristicamente	carateristicamente	RG
carecidamente	carecidamente	RG
caricatamente	caricatamente	RG
caricaturalmente	caricaturalmente	RG
cariciativamente	cariciativamente	RG
cariciosamente	cariciosamente	RG
caridosamente	caridosamente	RG
carinhosamente	carinhosamente	RG
caritativamente	caritativamente	RG
carnavalescamente	carnavalescamente	RG
carniceiramente	carniceiramente	RG
carrancudamente	carrancudamente	RG
castamente	castamente	RG
castelhanamente	castelhanamente	RG
castiçamente	castiçamente	RG
casualmente	casualmente	RG
casuisticamente	casuisticamente	RG
cataliticamente	cataliticamente	RG
catarticamente	catarticamente	RG
catastroficamente	catastroficamente	RG
catedraticamente	catedraticamente	RG
categoricamente	categoricamente	RG
cativantemente	cativantemente	RG
catolicamente	catolicamente	RG
caudalosamente	caudalosamente	RG
causticamente	causticamente	RG
cautamente	cautamente	RG
cautelosamente	cautelosamente	RG
cavaleiramente	cavaleiramente	RG
cavalheirescamente	cavalheirescamente	RG
cavalheirosamente	cavalheirosamente	RG
cavamente	cavamente	RG
cavernosamente	cavernosamente	RG
cavilosamente	cavilosamente	RG
cegamente	cegamente	RG
celebremente	celebremente	RG
celeradamente	celeradamente	RG
celeremente	celeremente	RG
celestialmente	celestialmente	RG
cenicamente	cenicamente	RG
cenograficamente	cenograficamente	RG
censualmente	censualmente	RG
censuravelmente	censuravelmente	RG
centralmente	centralmente	RG
centuplicadamente	centuplicadamente	RG
cerebralmente	cerebralmente	RG
cerebrinamente	cerebrinamente	RG
cerimoniaticamente	cerimoniaticamente	RG
cerimoniosamente	cerimoniosamente	RG
cerradamente	cerradamente	RG
certamente	certamente	RG
certeiramente	certeiramente	RG
charadisticamente	charadisticamente	RG
charramente	charramente	RG
chatamente	chatamente	RG
chistosamente	chistosamente	RG
chorosamente	chorosamente	RG
chulamente	chulamente	RG
ciclicamente	ciclicamente	RG
ciclopicamente	ciclopicamente	RG
cientemente	cientemente	RG
cientificamente	cientificamente	RG
cilindricamente	cilindricamente	RG
cinematograficamente	cinematograficamente	RG
cineticamente	cineticamente	RG
cinicamente	cinicamente	RG
ciosamente	ciosamente	RG
circularmente	circularmente	RG
circulatoriamente	circulatoriamente	RG
circunflexamente	circunflexamente	RG
circunspectamente	circunspectamente	RG
circunspetamente	circunspetamente	RG
circunstanciadamente	circunstanciadamente	RG
circunstancialmente	circunstancialmente	RG
cirurgicamente	cirurgicamente	RG
citologicamente	citologicamente	RG
civicamente	civicamente	RG
civilizadamente	civilizadamente	RG
civilmente	civilmente	RG
clamorosamente	clamorosamente	RG
clandestinamente	clandestinamente	RG
clangorosamente	clangorosamente	RG
claramente	claramente	RG
classicamente	classicamente	RG
clementemente	clementemente	RG
clericalmente	clericalmente	RG
climaticamente	climaticamente	RG
clinicamente	clinicamente	RG
coactivamente	coactivamente	RG
coativamente	coativamente	RG
cobardemente	cobardemente	RG
cobiçosamente	cobiçosamente	RG
coercitivamente	coercitivamente	RG
coercivamente	coercivamente	RG
coerentemente	coerentemente	RG
coessencialmente	coessencialmente	RG
coetaneamente	coetaneamente	RG
cogitativamente	cogitativamente	RG
cognitivamente	cognitivamente	RG
coincidentemente	coincidentemente	RG
colateralmente	colateralmente	RG
colectivamente	colectivamente	RG
colegialmente	colegialmente	RG
colericamente	colericamente	RG
coletivamente	coletivamente	RG
colonialmente	colonialmente	RG
colossalmente	colossalmente	RG
combativamente	combativamente	RG
combinatoriamente	combinatoriamente	RG
comedidamente	comedidamente	RG
comercialmente	comercialmente	RG
comezinhamente	comezinhamente	RG
comicamente	comicamente	RG
cominativamente	cominativamente	RG
cominatoriamente	cominatoriamente	RG
comitativamente	comitativamente	RG
comodamente	comodamente	RG
comovidamente	comovidamente	RG
compactamente	compactamente	RG
compadecidamente	compadecidamente	RG
comparativamente	comparativamente	RG
comparavelmente	comparavelmente	RG
compassadamente	compassadamente	RG
compassivamente	compassivamente	RG
compativelmente	compativelmente	RG
compendiosamente	compendiosamente	RG
compenetradamente	compenetradamente	RG
compensativamente	compensativamente	RG
compensatoriamente	compensatoriamente	RG
complacentemente	complacentemente	RG
complementarmente	complementarmente	RG
completamente	completamente	RG
complexamente	complexamente	RG
complicadamente	complicadamente	RG
comportavelmente	comportavelmente	RG
compostamente	compostamente	RG
compreensivamente	compreensivamente	RG
compreensivelmente	compreensivelmente	RG
compressivamente	compressivamente	RG
compridamente	compridamente	RG
comprimidamente	comprimidamente	RG
comprobativamente	comprobativamente	RG
comprobatoriamente	comprobatoriamente	RG
comprovadamente	comprovadamente	RG
comprovativamente	comprovativamente	RG
compulsivamente	compulsivamente	RG
compulsoriamente	compulsoriamente	RG
compungidamente	compungidamente	RG
comumente	comumente	RG
comummente	comummente	RG
comunicativamente	comunicativamente	RG
comunitariamente	comunitariamente	RG
comutativamente	comutativamente	RG
conceitualmente	conceitualmente	RG
conceituosamente	conceituosamente	RG
concentradamente	concentradamente	RG
concentricamente	concentricamente	RG
conceptualmente	conceptualmente	RG
concertadamente	concertadamente	RG
concessivamente	concessivamente	RG
concetualmente	concetualmente	RG
conciliativamente	conciliativamente	RG
conciliatoriamente	conciliatoriamente	RG
concisamente	concisamente	RG
concludentemente	concludentemente	RG
conclusivamente	conclusivamente	RG
concomitantemente	concomitantemente	RG
concorrentemente	concorrentemente	RG
concretamente	concretamente	RG
condenavelmente	condenavelmente	RG
condensadamente	condensadamente	RG
condicionalmente	condicionalmente	RG
condignamente	condignamente	RG
conexamente	conexamente	RG
confederadamente	confederadamente	RG
confederativamente	confederativamente	RG
confessadamente	confessadamente	RG
confiadamente	confiadamente	RG
confidencialmente	confidencialmente	RG
confirmativamente	confirmativamente	RG
conflituosamente	conflituosamente	RG
conformemente	conformemente	RG
confortavelmente	confortavelmente	RG
confrangedoramente	confrangedoramente	RG
confundidamente	confundidamente	RG
confusamente	confusamente	RG
congenialmente	congenialmente	RG
congratulatoriamente	congratulatoriamente	RG
congruentemente	congruentemente	RG
conjecturalmente	conjecturalmente	RG
conjeturalmente	conjeturalmente	RG
conjugalmente	conjugalmente	RG
conjuncionalmente	conjuncionalmente	RG
conjuntamente	conjuntamente	RG
conjunturalmente	conjunturalmente	RG
conotativamente	conotativamente	RG
conscienciosamente	conscienciosamente	RG
conscientemente	conscientemente	RG
consecutivamente	consecutivamente	RG
conseguintemente	conseguintemente	RG
conselheiralmente	conselheiralmente	RG
consensualmente	consensualmente	RG
consentaneamente	consentaneamente	RG
consequentemente	consequentemente	RG
conseqüentemente	conseqüentemente	RG
consideradamente	consideradamente	RG
consideravelmente	consideravelmente	RG
consistentemente	consistentemente	RG
consoladamente	consoladamente	RG
consoladoramente	consoladoramente	RG
consonanticamente	consonanticamente	RG
conspicuamente	conspicuamente	RG
constantemente	constantemente	RG
constitucionalmente	constitucionalmente	RG
constrangidamente	constrangidamente	RG
construtivamente	construtivamente	RG
consubstancialmente	consubstancialmente	RG
consuetudinariamente	consuetudinariamente	RG
consularmente	consularmente	RG
consumadamente	consumadamente	RG
contabilisticamente	contabilisticamente	RG
contagiosamente	contagiosamente	RG
contemplativamente	contemplativamente	RG
contemporaneamente	contemporaneamente	RG
contenciosamente	contenciosamente	RG
contiguamente	contiguamente	RG
contingentemente	contingentemente	RG
continuadamente	continuadamente	RG
continuamente	continuamente	RG
contraditoriamente	contraditoriamente	RG
contrariamente	contrariamente	RG
contratualmente	contratualmente	RG
contritamente	contritamente	RG
contumazmente	contumazmente	RG
contumeliosamente	contumeliosamente	RG
contundentemente	contundentemente	RG
conturbadamente	conturbadamente	RG
convencionalmente	convencionalmente	RG
convenientemente	convenientemente	RG
conventualmente	conventualmente	RG
convictamente	convictamente	RG
convidativamente	convidativamente	RG
convincentemente	convincentemente	RG
convulsamente	convulsamente	RG
convulsivamente	convulsivamente	RG
coordenativamente	coordenativamente	RG
copiosamente	copiosamente	RG
copulativamente	copulativamente	RG
corajosamente	corajosamente	RG
cordatamente	cordatamente	RG
cordialmente	cordialmente	RG
corneamente	corneamente	RG
corograficamente	corograficamente	RG
corporalmente	corporalmente	RG
corporativamente	corporativamente	RG
corporeamente	corporeamente	RG
correcionalmente	correcionalmente	RG
correctivamente	correctivamente	RG
correlativamente	correlativamente	RG
correntemente	correntemente	RG
correntiamente	correntiamente	RG
corretamente	corretamente	RG
corretivamente	corretivamente	RG
corrosivamente	corrosivamente	RG
corruptamente	corruptamente	RG
cortantemente	cortantemente	RG
cortesmente	cortesmente	RG
cosmicamente	cosmicamente	RG
costumadamente	costumadamente	RG
cotidianamente	cotidianamente	RG
covardemente	covardemente	RG
crapulosamente	crapulosamente	RG
crassamente	crassamente	RG
credivelmente	credivelmente	RG
credulamente	credulamente	RG
crescentemente	crescentemente	RG
crespamente	crespamente	RG
criminalmente	criminalmente	RG
criminosamente	criminosamente	RG
criptograficamente	criptograficamente	RG
cristãmente	cristãmente	RG
criteriosamente	criteriosamente	RG
criticamente	criticamente	RG
cronicamente	cronicamente	RG
cronograficamente	cronograficamente	RG
cronologicamente	cronologicamente	RG
cronometricamente	cronometricamente	RG
cruamente	cruamente	RG
crucialmente	crucialmente	RG
cruelmente	cruelmente	RG
cruzadamente	cruzadamente	RG
cubicamente	cubicamente	RG
cuidadosamente	cuidadosamente	RG
culposamente	culposamente	RG
cultamente	cultamente	RG
culturalmente	culturalmente	RG
cumulativamente	cumulativamente	RG
cupidamente	cupidamente	RG
cupidinosamente	cupidinosamente	RG
curialmente	curialmente	RG
curiosamente	curiosamente	RG
curricularmente	curricularmente	RG
curtamente	curtamente	RG
custosamente	custosamente	RG
dactilograficamente	dactilograficamente	RG
dadivosamente	dadivosamente	RG
danosamente	danosamente	RG
datilograficamente	datilograficamente	RG
deambulatóriamente	deambulatóriamente	RG
debilmente	debilmente	RG
decentemente	decentemente	RG
decididamente	decididamente	RG
decimalmente	decimalmente	RG
decisivamente	decisivamente	RG
decisoriamente	decisoriamente	RG
declamativamente	declamativamente	RG
declamatoriamente	declamatoriamente	RG
declaradamente	declaradamente	RG
declarativamente	declarativamente	RG
declaratoriamente	declaratoriamente	RG
decorativamente	decorativamente	RG
decorosamente	decorosamente	RG
decrepitamente	decrepitamente	RG
decretalmente	decretalmente	RG
decretoriamente	decretoriamente	RG
decursivamente	decursivamente	RG
dedicadamente	dedicadamente	RG
dedutivamente	dedutivamente	RG
defeituosamente	defeituosamente	RG
defensavelmente	defensavelmente	RG
defensivamente	defensivamente	RG
deferentemente	deferentemente	RG
deficientemente	deficientemente	RG
deficitariamente	deficitariamente	RG
definidamente	definidamente	RG
definitivamente	definitivamente	RG
deleitavelmente	deleitavelmente	RG
deleitosamente	deleitosamente	RG
deleuzianamente	deleuzianamente	RG
delgadamente	delgadamente	RG
deliberadamente	deliberadamente	RG
deliberativamente	deliberativamente	RG
delicadamente	delicadamente	RG
deliciosamente	deliciosamente	RG
delirantemente	delirantemente	RG
demagogicamente	demagogicamente	RG
demasiadamente	demasiadamente	RG
demitademente	demitademente	RG
democraticamente	democraticamente	RG
demograficamente	demograficamente	RG
demoniacamente	demoniacamente	RG
demonstrativamente	demonstrativamente	RG
demoradamente	demoradamente	RG
dengosamente	dengosamente	RG
denodadamente	denodadamente	RG
densamente	densamente	RG
deplorativamente	deplorativamente	RG
deploravelmente	deploravelmente	RG
depravadamente	depravadamente	RG
deprecativamente	deprecativamente	RG
depreciativamente	depreciativamente	RG
depressivamente	depressivamente	RG
derradeiramente	derradeiramente	RG
desabaladamente	desabaladamente	RG
desabridamente	desabridamente	RG
desabrigadamente	desabrigadamente	RG
desabusadamente	desabusadamente	RG
desacertadamente	desacertadamente	RG
desaconselhavelmente	desaconselhavelmente	RG
desadequadamente	desadequadamente	RG
desafectadamente	desafectadamente	RG
desafetadamente	desafetadamente	RG
desafinadamente	desafinadamente	RG
desafogadamente	desafogadamente	RG
desaforadamente	desaforadamente	RG
desafortunadamente	desafortunadamente	RG
desagradavelmente	desagradavelmente	RG
desagradecidamente	desagradecidamente	RG
desairosamente	desairosamente	RG
desajeitadamente	desajeitadamente	RG
desajuizadamente	desajuizadamente	RG
desalentadamente	desalentadamente	RG
desalinhadamente	desalinhadamente	RG
desalmadamente	desalmadamente	RG
desamavelmente	desamavelmente	RG
desambiciosamente	desambiciosamente	RG
desamoravelmente	desamoravelmente	RG
desamparadamente	desamparadamente	RG
desanimadamente	desanimadamente	RG
desapaixonadamente	desapaixonadamente	RG
desapiedadamente	desapiedadamente	RG
desarmoniosamente	desarmoniosamente	RG
desarranjadamente	desarranjadamente	RG
desarrazoadamente	desarrazoadamente	RG
desarticuladamente	desarticuladamente	RG
desasadamente	desasadamente	RG
desassisadamente	desassisadamente	RG
desassombradamente	desassombradamente	RG
desastradamente	desastradamente	RG
desastrosamente	desastrosamente	RG
desataviadamente	desataviadamente	RG
desatenciosamente	desatenciosamente	RG
desatentamente	desatentamente	RG
desatinadamente	desatinadamente	RG
desaustinadamente	desaustinadamente	RG
desaventuradamente	desaventuradamente	RG
desavergonhadamente	desavergonhadamente	RG
desavisadamente	desavisadamente	RG
desazadamente	desazadamente	RG
desbocadamente	desbocadamente	RG
desbragadamente	desbragadamente	RG
descabeladamente	descabeladamente	RG
descabidamente	descabidamente	RG
descansadamente	descansadamente	RG
descaradamente	descaradamente	RG
descaridosamente	descaridosamente	RG
descarinhosamente	descarinhosamente	RG
descautelosamente	descautelosamente	RG
descensionalmente	descensionalmente	RG
descerimoniosamente	descerimoniosamente	RG
descobertamente	descobertamente	RG
descocadamente	descocadamente	RG
descomedidamente	descomedidamente	RG
descompassadamente	descompassadamente	RG
descompostamente	descompostamente	RG
descomunalmente	descomunalmente	RG
desconcertadamente	desconcertadamente	RG
desconchavadamente	desconchavadamente	RG
desconexamente	desconexamente	RG
desconfiadamente	desconfiadamente	RG
desconformemente	desconformemente	RG
desconfortavelmente	desconfortavelmente	RG
desconsoladamente	desconsoladamente	RG
desconsoladoramente	desconsoladoramente	RG
descontraidamente	descontraidamente	RG
descoordenadamente	descoordenadamente	RG
descortesmente	descortesmente	RG
descosidamente	descosidamente	RG
descuidadamente	descuidadamente	RG
descuidosamente	descuidosamente	RG
desculpavelmente	desculpavelmente	RG
descuradamente	descuradamente	RG
descuriosamente	descuriosamente	RG
desdenhosamente	desdenhosamente	RG
desditosamente	desditosamente	RG
desejavelmente	desejavelmente	RG
desejosamente	desejosamente	RG
deselegantemente	deselegantemente	RG
desembaraçadamente	desembaraçadamente	RG
desembestadamente	desembestadamente	RG
desembuçadamente	desembuçadamente	RG
desempenadamente	desempenadamente	RG
desempoeiradamente	desempoeiradamente	RG
desencabrestadamente	desencabrestadamente	RG
desencadernadamente	desencadernadamente	RG
desencantadoramente	desencantadoramente	RG
desencontradamente	desencontradamente	RG
desencorajadamente	desencorajadamente	RG
desenfastiadamente	desenfastiadamente	RG
desenfreadamente	desenfreadamente	RG
desenganadamente	desenganadamente	RG
desengenhosamente	desengenhosamente	RG
desengonçadamente	desengonçadamente	RG
desengraçadamente	desengraçadamente	RG
desentendidamente	desentendidamente	RG
desentoadamente	desentoadamente	RG
desenvoltamente	desenvoltamente	RG
desenvolvidamente	desenvolvidamente	RG
desenxabidamente	desenxabidamente	RG
desenxovalhadamente	desenxovalhadamente	RG
desequilibradamente	desequilibradamente	RG
desesperadamente	desesperadamente	RG
desesperadoramente	desesperadoramente	RG
desesperativamente	desesperativamente	RG
desfavoravelmente	desfavoravelmente	RG
desfaçadamente	desfaçadamente	RG
desgarradamente	desgarradamente	RG
desgostosamente	desgostosamente	RG
desgovernadamente	desgovernadamente	RG
desgraciosamente	desgraciosamente	RG
desgraçadamente	desgraçadamente	RG
desidiosamente	desidiosamente	RG
designadamente	designadamente	RG
desigualmente	desigualmente	RG
desinteressadamente	desinteressadamente	RG
desinvejosamente	desinvejosamente	RG
desirmanadamente	desirmanadamente	RG
desjeitosamente	desjeitosamente	RG
deslealmente	deslealmente	RG
desleixadamente	desleixadamente	RG
deslinguadamente	deslinguadamente	RG
deslumbrantemente	deslumbrantemente	RG
desluzidamente	desluzidamente	RG
desmaiadamente	desmaiadamente	RG
desmarcadamente	desmarcadamente	RG
desmazeladamente	desmazeladamente	RG
desmedidamente	desmedidamente	RG
desmesuradamente	desmesuradamente	RG
desmoderadamente	desmoderadamente	RG
desnecessariamente	desnecessariamente	RG
desnorteadamente	desnorteadamente	RG
desoladamente	desoladamente	RG
desoladoramente	desoladoramente	RG
desonestamente	desonestamente	RG
desonrosamente	desonrosamente	RG
desordenadamente	desordenadamente	RG
desorganizadamente	desorganizadamente	RG
desorientadamente	desorientadamente	RG
despachadamente	despachadamente	RG
despejadamente	despejadamente	RG
despercebidamente	despercebidamente	RG
desperdiçadamente	desperdiçadamente	RG
despicientemente	despicientemente	RG
despiedadamente	despiedadamente	RG
despiedosamente	despiedosamente	RG
despojadamente	despojadamente	RG
desportivamente	desportivamente	RG
despoticamente	despoticamente	RG
desprecatadamente	desprecatadamente	RG
desprendidamente	desprendidamente	RG
despreocupadamente	despreocupadamente	RG
despretensiosamente	despretensiosamente	RG
desprezivelmente	desprezivelmente	RG
desprimorosamente	desprimorosamente	RG
desproporcionadamente	desproporcionadamente	RG
desproporcionalmente	desproporcionalmente	RG
despropositadamente	despropositadamente	RG
desregradamente	desregradamente	RG
desrespeitosamente	desrespeitosamente	RG
dessaboridamente	dessaboridamente	RG
dessemelhantemente	dessemelhantemente	RG
destacadamente	destacadamente	RG
destampadamente	destampadamente	RG
destemidamente	destemidamente	RG
destemperadamente	destemperadamente	RG
destoadamente	destoadamente	RG
destrambelhadamente	destrambelhadamente	RG
destramente	destramente	RG
destrutivamente	destrutivamente	RG
desumanamente	desumanamente	RG
desusadamente	desusadamente	RG
desvairadamente	desvairadamente	RG
desvaliosamente	desvaliosamente	RG
desvanecidamente	desvanecidamente	RG
desvantajosamente	desvantajosamente	RG
desveladamente	desveladamente	RG
desventuradamente	desventuradamente	RG
detalhadamente	detalhadamente	RG
determinadamente	determinadamente	RG
determinativamente	determinativamente	RG
detestavelmente	detestavelmente	RG
detidamente	detidamente	RG
devassamente	devassamente	RG
devidamente	devidamente	RG
devoradoramente	devoradoramente	RG
devotadamente	devotadamente	RG
devotamente	devotamente	RG
diabolicamente	diabolicamente	RG
diabrilmente	diabrilmente	RG
diacriticamente	diacriticamente	RG
diacronicamente	diacronicamente	RG
diafanamente	diafanamente	RG
diagonalmente	diagonalmente	RG
dialectalmente	dialectalmente	RG
dialecticamente	dialecticamente	RG
dialetalmente	dialetalmente	RG
dialeticamente	dialeticamente	RG
dialogalmente	dialogalmente	RG
dialogicamente	dialogicamente	RG
diamantinamente	diamantinamente	RG
diametralmente	diametralmente	RG
diariamente	diariamente	RG
diatonicamente	diatonicamente	RG
diatopicamente	diatopicamente	RG
dicionaristicamente	dicionaristicamente	RG
dicotomicamente	dicotomicamente	RG
didacticamente	didacticamente	RG
didascalicamente	didascalicamente	RG
didaticamente	didaticamente	RG
dieteticamente	dieteticamente	RG
diferencialmente	diferencialmente	RG
diferentemente	diferentemente	RG
dificilmente	dificilmente	RG
dificultosamente	dificultosamente	RG
difusamente	difusamente	RG
digitalmente	digitalmente	RG
dignamente	dignamente	RG
digressivamente	digressivamente	RG
dilatadamente	dilatadamente	RG
dilatoriamente	dilatoriamente	RG
dilematicamente	dilematicamente	RG
diletantemente	diletantemente	RG
diligentemente	diligentemente	RG
diminutamente	diminutamente	RG
dinamicamente	dinamicamente	RG
dinasticamente	dinasticamente	RG
diplomaticamente	diplomaticamente	RG
direitamente	direitamente	RG
diretamente	diretamente	RG
disciplinadamente	disciplinadamente	RG
disciplinarmente	disciplinarmente	RG
discordemente	discordemente	RG
discretamente	discretamente	RG
discricionariamente	discricionariamente	RG
discriminadamente	discriminadamente	RG
discursivamente	discursivamente	RG
disfarçadamente	disfarçadamente	RG
disformemente	disformemente	RG
disjuntivamente	disjuntivamente	RG
disparatadamente	disparatadamente	RG
dispendiosamente	dispendiosamente	RG
dispensavelmente	dispensavelmente	RG
dispersamente	dispersamente	RG
dispersivamente	dispersivamente	RG
displicentemente	displicentemente	RG
dispositivamente	dispositivamente	RG
dissemelhantemente	dissemelhantemente	RG
dissilabicamente	dissilabicamente	RG
dissimetricamente	dissimetricamente	RG
dissimuladamente	dissimuladamente	RG
dissolutamente	dissolutamente	RG
distintamente	distintamente	RG
distraidamente	distraidamente	RG
distributivamente	distributivamente	RG
ditatorialmente	ditatorialmente	RG
ditirambicamente	ditirambicamente	RG
ditosamente	ditosamente	RG
diuturnamente	diuturnamente	RG
diversamente	diversamente	RG
diversificadamente	diversificadamente	RG
divertidamente	divertidamente	RG
divinalmente	divinalmente	RG
divinamente	divinamente	RG
dobradamente	dobradamente	RG
docemente	docemente	RG
docilmente	docilmente	RG
documentalmente	documentalmente	RG
doentiamente	doentiamente	RG
dogmaticamente	dogmaticamente	RG
doidamente	doidamente	RG
doloridamente	doloridamente	RG
dolorosamente	dolorosamente	RG
dolosamente	dolosamente	RG
domesticamente	domesticamente	RG
domiciliariamente	domiciliariamente	RG
dominantemente	dominantemente	RG
domingueiramente	domingueiramente	RG
donairosamente	donairosamente	RG
donosamente	donosamente	RG
doricamente	doricamente	RG
doridamente	doridamente	RG
doudamente	doudamente	RG
doutamente	doutamente	RG
doutoralmente	doutoralmente	RG
doutrinalmente	doutrinalmente	RG
doutrinariamente	doutrinariamente	RG
draconianamente	draconianamente	RG
dramaticamente	dramaticamente	RG
drasticamente	drasticamente	RG
dubiamente	dubiamente	RG
dubitativamente	dubitativamente	RG
ductilmente	ductilmente	RG
duplamente	duplamente	RG
duplicadamente	duplicadamente	RG
duplicemente	duplicemente	RG
duradouramente	duradouramente	RG
duramente	duramente	RG
duravelmente	duravelmente	RG
duvidosamente	duvidosamente	RG
eclesiasticamente	eclesiasticamente	RG
ecleticamente	ecleticamente	RG
ecologicamente	ecologicamente	RG
economicamente	economicamente	RG
ecumenicamente	ecumenicamente	RG
edificantemente	edificantemente	RG
editorialmente	editorialmente	RG
educadamente	educadamente	RG
educativamente	educativamente	RG
efemeramente	efemeramente	RG
efeminadamente	efeminadamente	RG
efetivamente	efetivamente	RG
eficazmente	eficazmente	RG
eficientemente	eficientemente	RG
efusivamente	efusivamente	RG
egocentricamente	egocentricamente	RG
egoistamente	egoistamente	RG
egoisticamente	egoisticamente	RG
egregiamente	egregiamente	RG
elasticamente	elasticamente	RG
electricamente	electricamente	RG
electronicamente	electronicamente	RG
elegantemente	elegantemente	RG
eleitoralmente	eleitoralmente	RG
elementarmente	elementarmente	RG
eletivamente	eletivamente	RG
eletricamente	eletricamente	RG
eletronicamente	eletronicamente	RG
elevadamente	elevadamente	RG
elipticamente	elipticamente	RG
elogiosamente	elogiosamente	RG
eloquentemente	eloquentemente	RG
elucidativamente	elucidativamente	RG
emaranhadamente	emaranhadamente	RG
embaraçadamente	embaraçadamente	RG
embaraçosamente	embaraçosamente	RG
emblematicamente	emblematicamente	RG
embrionariamente	embrionariamente	RG
emeritamente	emeritamente	RG
eminencialmente	eminencialmente	RG
eminentemente	eminentemente	RG
emocionalmente	emocionalmente	RG
emotivamente	emotivamente	RG
empausadamente	empausadamente	RG
empenhadamente	empenhadamente	RG
empertigadamente	empertigadamente	RG
empiricamente	empiricamente	RG
empoladamente	empoladamente	RG
emproadamente	emproadamente	RG
encantadoramente	encantadoramente	RG
encarecidamente	encarecidamente	RG
encarniçadamente	encarniçadamente	RG
enciclopedicamente	enciclopedicamente	RG
encliticamente	encliticamente	RG
encobertamente	encobertamente	RG
encolhidamente	encolhidamente	RG
encomiasticamente	encomiasticamente	RG
endemicamente	endemicamente	RG
endiabradamente	endiabradamente	RG
energeticamente	energeticamente	RG
energicamente	energicamente	RG
enfadonhamente	enfadonhamente	RG
enfadosamente	enfadosamente	RG
enfaticamente	enfaticamente	RG
enfatuadamente	enfatuadamente	RG
enganosamente	enganosamente	RG
engenhosamente	engenhosamente	RG
engraçadamente	engraçadamente	RG
enigmaticamente	enigmaticamente	RG
enjoativamente	enjoativamente	RG
enormemente	enormemente	RG
enternecidamente	enternecidamente	RG
entranhadamente	entranhadamente	RG
entusiasticamente	entusiasticamente	RG
envaidecidamente	envaidecidamente	RG
envergonhadamente	envergonhadamente	RG
enviesadamente	enviesadamente	RG
enxovalhadamente	enxovalhadamente	RG
enxundiosamente	enxundiosamente	RG
eolicamente	eolicamente	RG
epenteticamente	epenteticamente	RG
epicamente	epicamente	RG
epidemiologicamente	epidemiologicamente	RG
epigraficamente	epigraficamente	RG
epigramaticamente	epigramaticamente	RG
episodicamente	episodicamente	RG
epistemologicamente	epistemologicamente	RG
epistolarmente	epistolarmente	RG
equilibradamente	equilibradamente	RG
equitativamente	equitativamente	RG
equivocamente	equivocamente	RG
erectamente	erectamente	RG
eremiticamente	eremiticamente	RG
eretamente	eretamente	RG
eroticamente	eroticamente	RG
erradamente	erradamente	RG
erroneamente	erroneamente	RG
eruditamente	eruditamente	RG
esbaforidamente	esbaforidamente	RG
esbeltamente	esbeltamente	RG
escabrosamente	escabrosamente	RG
escandalosamente	escandalosamente	RG
escapatoriamente	escapatoriamente	RG
escassamente	escassamente	RG
esclarecidamente	esclarecidamente	RG
escolarmente	escolarmente	RG
escolasticamente	escolasticamente	RG
escolhidamente	escolhidamente	RG
escondidamente	escondidamente	RG
escorreitamente	escorreitamente	RG
escrupulosamente	escrupulosamente	RG
esculturalmente	esculturalmente	RG
escuramente	escuramente	RG
escusadamente	escusadamente	RG
escusamente	escusamente	RG
esdruxulamente	esdruxulamente	RG
esfericamente	esfericamente	RG
esfingicamente	esfingicamente	RG
esforçadamente	esforçadamente	RG
esfuziantemente	esfuziantemente	RG
esganiçadamente	esganiçadamente	RG
esmagadoramente	esmagadoramente	RG
esmeradamente	esmeradamente	RG
espacialmente	espacialmente	RG
espalhafatosamente	espalhafatosamente	RG
espalmadamente	espalmadamente	RG
espantosamente	espantosamente	RG
esparsamente	esparsamente	RG
espasmodicamente	espasmodicamente	RG
espaventosamente	espaventosamente	RG
espaçadamente	espaçadamente	RG
espaçosamente	espaçosamente	RG
especialmente	especialmente	RG
especificadamente	especificadamente	RG
especificamente	especificamente	RG
especiosamente	especiosamente	RG
especulativamente	especulativamente	RG
esperançosamente	esperançosamente	RG
esperavelmente	esperavelmente	RG
espertamente	espertamente	RG
espessamente	espessamente	RG
espetacularmente	espetacularmente	RG
espetaculosamente	espetaculosamente	RG
espevitadamente	espevitadamente	RG
espiralmente	espiralmente	RG
espiritualmente	espiritualmente	RG
espirituosamente	espirituosamente	RG
esplendidamente	esplendidamente	RG
esplendorosamente	esplendorosamente	RG
espoliativamente	espoliativamente	RG
esponencialmente	esponencialmente	RG
espontaneamente	espontaneamente	RG
esporadicamente	esporadicamente	RG
esportivamente	esportivamente	RG
esqueleticamente	esqueleticamente	RG
esquematicamente	esquematicamente	RG
esquisitamente	esquisitamente	RG
esquivamente	esquivamente	RG
essencialmente	essencialmente	RG
estabalhoadamente	estabalhoadamente	RG
estacionariamente	estacionariamente	RG
estadisticamente	estadisticamente	RG
estateladamente	estateladamente	RG
estaticamente	estaticamente	RG
estatisticamente	estatisticamente	RG
estatutariamente	estatutariamente	RG
estavelmente	estavelmente	RG
estenograficamente	estenograficamente	RG
esterilmente	esterilmente	RG
esteticamente	esteticamente	RG
estilisticamente	estilisticamente	RG
estocasticamente	estocasticamente	RG
estoicamente	estoicamente	RG
estolidamente	estolidamente	RG
estouvadamente	estouvadamente	RG
estrabicamente	estrabicamente	RG
estragadamente	estragadamente	RG
estrangeiradamente	estrangeiradamente	RG
estranhamente	estranhamente	RG
estrategicamente	estrategicamente	RG
estreitamente	estreitamente	RG
estremecidamente	estremecidamente	RG
estrenuamente	estrenuamente	RG
estrepitosamente	estrepitosamente	RG
estridentemente	estridentemente	RG
estridulamente	estridulamente	RG
estritamente	estritamente	RG
estroficamente	estroficamente	RG
estrondosamente	estrondosamente	RG
estropeadamente	estropeadamente	RG
estruturalmente	estruturalmente	RG
estudadamente	estudadamente	RG
estudiosamente	estudiosamente	RG
estultamente	estultamente	RG
estupendamente	estupendamente	RG
estupidamente	estupidamente	RG
esturdiamente	esturdiamente	RG
etereamente	etereamente	RG
eternalmente	eternalmente	RG
eternamente	eternamente	RG
eticamente	eticamente	RG
etimologicamente	etimologicamente	RG
etiologicamente	etiologicamente	RG
etiopicamente	etiopicamente	RG
etnicamente	etnicamente	RG
etnograficamente	etnograficamente	RG
etnologicamente	etnologicamente	RG
eufemicamente	eufemicamente	RG
eufemisticamente	eufemisticamente	RG
euforicamente	euforicamente	RG
evangelicamente	evangelicamente	RG
evasivamente	evasivamente	RG
eventualmente	eventualmente	RG
evidentemente	evidentemente	RG
evocativamente	evocativamente	RG
evolutivamente	evolutivamente	RG
exacerbadamente	exacerbadamente	RG
exactamente	exactamente	RG
exageradamente	exageradamente	RG
exaltadamente	exaltadamente	RG
exasperadamente	exasperadamente	RG
exatamente	exatamente	RG
exatissimamente	exatissimamente	RG
exaustivamente	exaustivamente	RG
excecionalmente	excecionalmente	RG
excelentemente	excelentemente	RG
excelsamente	excelsamente	RG
excentricamente	excentricamente	RG
excepcionalmente	excepcionalmente	RG
excessivamente	excessivamente	RG
excitantemente	excitantemente	RG
exclamativamente	exclamativamente	RG
exclusivamente	exclusivamente	RG
execravelmente	execravelmente	RG
executivamente	executivamente	RG
executoriamente	executoriamente	RG
exegeticamente	exegeticamente	RG
exemplarmente	exemplarmente	RG
exemplificativamente	exemplificativamente	RG
exiguamente	exiguamente	RG
eximiamente	eximiamente	RG
exogenamente	exogenamente	RG
exorbitantemente	exorbitantemente	RG
exortativamente	exortativamente	RG
exortatoriamente	exortatoriamente	RG
exoticamente	exoticamente	RG
expansivamente	expansivamente	RG
expeditamente	expeditamente	RG
experimentalmente	experimentalmente	RG
expletivamente	expletivamente	RG
explicativamente	explicativamente	RG
explicitamente	explicitamente	RG
explosivamente	explosivamente	RG
exponencialmente	exponencialmente	RG
expositivamente	expositivamente	RG
expressamente	expressamente	RG
expressionalmente	expressionalmente	RG
expressivamente	expressivamente	RG
extaticamente	extaticamente	RG
extemporaneamente	extemporaneamente	RG
extensamente	extensamente	RG
extensivamente	extensivamente	RG
extenuadamente	extenuadamente	RG
exteriormente	exteriormente	RG
externamente	externamente	RG
extrajudicialmente	extrajudicialmente	RG
extrajudiciariamente	extrajudiciariamente	RG
extralegalmente	extralegalmente	RG
extramaritalmente	extramaritalmente	RG
extranaturalmente	extranaturalmente	RG
extraoficialmente	extraoficialmente	RG
extraordinariamente	extraordinariamente	RG
extravagantemente	extravagantemente	RG
extremadamente	extremadamente	RG
extremamente	extremamente	RG
extremosamente	extremosamente	RG
extrinsecamente	extrinsecamente	RG
exuberantemente	exuberantemente	RG
fabrilmente	fabrilmente	RG
fabulosamente	fabulosamente	RG
facciosamente	facciosamente	RG
faceiramente	faceiramente	RG
facetamente	facetamente	RG
facilmente	facilmente	RG
facinorosamente	facinorosamente	RG
facultativamente	facultativamente	RG
fadigosamente	fadigosamente	RG
fagueiramente	fagueiramente	RG
falaciosamente	falaciosamente	RG
falivelmente	falivelmente	RG
falsamente	falsamente	RG
familiarmente	familiarmente	RG
famosamente	famosamente	RG
fanaticamente	fanaticamente	RG
fantasiosamente	fantasiosamente	RG
fantasmagoricamente	fantasmagoricamente	RG
fantasticamente	fantasticamente	RG
farisaicamente	farisaicamente	RG
fartamente	fartamente	RG
fascinadoramente	fascinadoramente	RG
fascinantemente	fascinantemente	RG
fastidiosamente	fastidiosamente	RG
fatalmente	fatalmente	RG
fatidicamente	fatidicamente	RG
fatigantemente	fatigantemente	RG
fatuamente	fatuamente	RG
faustosamente	faustosamente	RG
faustuosamente	faustuosamente	RG
favoravelmente	favoravelmente	RG
façanhosamente	façanhosamente	RG
febrilmente	febrilmente	RG
fecundamente	fecundamente	RG
federalmente	federalmente	RG
federativamente	federativamente	RG
fedorentamente	fedorentamente	RG
feericamente	feericamente	RG
feiamente	feiamente	RG
felizmente	felizmente	RG
femealmente	femealmente	RG
feminilmente	feminilmente	RG
fenomenalmente	fenomenalmente	RG
feramente	feramente	RG
ferozmente	ferozmente	RG
ferreamente	ferreamente	RG
fertilmente	fertilmente	RG
ferventemente	ferventemente	RG
fervorosamente	fervorosamente	RG
festivamente	festivamente	RG
feudalmente	feudalmente	RG
ficcionalmente	ficcionalmente	RG
ficticiamente	ficticiamente	RG
fidalgamente	fidalgamente	RG
fiduciariamente	fiduciariamente	RG
fielmente	fielmente	RG
figadalmente	figadalmente	RG
figuradamente	figuradamente	RG
figurativamente	figurativamente	RG
filantropicamente	filantropicamente	RG
filauciosamente	filauciosamente	RG
filialmente	filialmente	RG
filogenicamente	filogenicamente	RG
filologicamente	filologicamente	RG
filosoficamente	filosoficamente	RG
finalmente	finalmente	RG
finamente	finamente	RG
financeiramente	financeiramente	RG
fingidamente	fingidamente	RG
finoriamente	finoriamente	RG
firmemente	firmemente	RG
fiscalmente	fiscalmente	RG
fisicamente	fisicamente	RG
fisiologicamente	fisiologicamente	RG
fisionomicamente	fisionomicamente	RG
fitamente	fitamente	RG
fixamente	fixamente	RG
flacidamente	flacidamente	RG
flagiciosamente	flagiciosamente	RG
flagrantemente	flagrantemente	RG
flebilmente	flebilmente	RG
fleumaticamente	fleumaticamente	RG
flexionalmente	flexionalmente	RG
flexivamente	flexivamente	RG
flexivelmente	flexivelmente	RG
flexuosamente	flexuosamente	RG
fluentemente	fluentemente	RG
fluidamente	fluidamente	RG
fogosamente	fogosamente	RG
folcloricamente	folcloricamente	RG
folgadamente	folgadamente	RG
foneticamente	foneticamente	RG
fonicamente	fonicamente	RG
fonologicamente	fonologicamente	RG
fonético-sintacticamente	fonético-sintacticamente	RG
fonético-sintaticamente	fonético-sintaticamente	RG
formalmente	formalmente	RG
formativamente	formativamente	RG
formidavelmente	formidavelmente	RG
formidolosamente	formidolosamente	RG
formosamente	formosamente	RG
formularmente	formularmente	RG
fortemente	fortemente	RG
fortuitamente	fortuitamente	RG
fortunosamente	fortunosamente	RG
forçadamente	forçadamente	RG
forçosamente	forçosamente	RG
fotocromaticamente	fotocromaticamente	RG
fotograficamente	fotograficamente	RG
fracamente	fracamente	RG
fragilmente	fragilmente	RG
fragmentariamente	fragmentariamente	RG
fragorosamente	fragorosamente	RG
francamente	francamente	RG
francesmente	francesmente	RG
fraseologicamente	fraseologicamente	RG
frasicamente	frasicamente	RG
fraternalmente	fraternalmente	RG
fraternamente	fraternamente	RG
fraudulentamente	fraudulentamente	RG
fraudulosamente	fraudulosamente	RG
freneticamente	freneticamente	RG
frequentemente	frequentemente	RG
frescamente	frescamente	RG
friamente	friamente	RG
frigidamente	frigidamente	RG
frivolamente	frivolamente	RG
froixamente	froixamente	RG
frontalmente	frontalmente	RG
frouxamente	frouxamente	RG
frugalmente	frugalmente	RG
frustradamente	frustradamente	RG
frutuosamente	frutuosamente	RG
fugazmente	fugazmente	RG
fugidiamente	fugidiamente	RG
fulgentemente	fulgentemente	RG
fulgidamente	fulgidamente	RG
fulgurantemente	fulgurantemente	RG
fulgurosamente	fulgurosamente	RG
fulminantemente	fulminantemente	RG
fumosamente	fumosamente	RG
funambulescamente	funambulescamente	RG
funcionalmente	funcionalmente	RG
fundamentalmente	fundamentalmente	RG
fundamente	fundamente	RG
funebremente	funebremente	RG
funeralmente	funeralmente	RG
funerariamente	funerariamente	RG
funereamente	funereamente	RG
funestamente	funestamente	RG
furiosamente	furiosamente	RG
furtivamente	furtivamente	RG
futebolisticamente	futebolisticamente	RG
futilmente	futilmente	RG
futuramente	futuramente	RG
físico-quimicamente	físico-quimicamente	RG
gagamente	gagamente	RG
gaiatamente	gaiatamente	RG
galantemente	galantemente	RG
galhardamente	galhardamente	RG
galhofeiramente	galhofeiramente	RG
gananciosamente	gananciosamente	RG
garbosamente	garbosamente	RG
garridamente	garridamente	RG
garrulamente	garrulamente	RG
gasalhosamente	gasalhosamente	RG
gelidamente	gelidamente	RG
geminadamente	geminadamente	RG
genealogicamente	genealogicamente	RG
generalizadamente	generalizadamente	RG
genericamente	genericamente	RG
generosamente	generosamente	RG
geneticamente	geneticamente	RG
genialmente	genialmente	RG
gentilicamente	gentilicamente	RG
gentilmente	gentilmente	RG
genuinamente	genuinamente	RG
geodesicamente	geodesicamente	RG
geodeticamente	geodeticamente	RG
geograficamente	geograficamente	RG
geográfico-linguisticamente	geográfico-linguisticamente	RG
geologicamente	geologicamente	RG
geometricamente	geometricamente	RG
geopoliticamente	geopoliticamente	RG
geralmente	geralmente	RG
germânicamente	germânicamente	RG
gigantescamente	gigantescamente	RG
ginasticamente	ginasticamente	RG
glacialmente	glacialmente	RG
globalmente	globalmente	RG
glorificativamente	glorificativamente	RG
gloriosamente	gloriosamente	RG
gloticamente	gloticamente	RG
glotologicamente	glotologicamente	RG
gnomicamente	gnomicamente	RG
gongoricamente	gongoricamente	RG
gostosamente	gostosamente	RG
governadamente	governadamente	RG
governamentalmente	governamentalmente	RG
gozosamente	gozosamente	RG
gracilmente	gracilmente	RG
graciosamente	graciosamente	RG
gradativamente	gradativamente	RG
graduadamente	graduadamente	RG
gradualmente	gradualmente	RG
graficamente	graficamente	RG
gramaticalmente	gramaticalmente	RG
grandemente	grandemente	RG
grandiosamente	grandiosamente	RG
gratamente	gratamente	RG
gratuitamente	gratuitamente	RG
gratulatoriamente	gratulatoriamente	RG
gravemente	gravemente	RG
gravosamente	gravosamente	RG
gregamente	gregamente	RG
gregariamente	gregariamente	RG
grosseiramente	grosseiramente	RG
grotescamente	grotescamente	RG
guapamente	guapamente	RG
guerreiramente	guerreiramente	RG
gulosamente	gulosamente	RG
guturalmente	guturalmente	RG
habilidosamente	habilidosamente	RG
habilmente	habilmente	RG
habitualmente	habitualmente	RG
harmonicamente	harmonicamente	RG
harmoniosamente	harmoniosamente	RG
hediondamente	hediondamente	RG
helenicamente	helenicamente	RG
helenisticamente	helenisticamente	RG
heraldicamente	heraldicamente	RG
hereditariamente	hereditariamente	RG
hereticamente	hereticamente	RG
hermenêuticamente	hermenêuticamente	RG
hermeticamente	hermeticamente	RG
heroicamente	heroicamente	RG
hesitantemente	hesitantemente	RG
heteroclitamente	heteroclitamente	RG
heterogeneamente	heterogeneamente	RG
heuristicamente	heuristicamente	RG
hibridamente	hibridamente	RG
hidraulicamente	hidraulicamente	RG
hierarquicamente	hierarquicamente	RG
hieraticamente	hieraticamente	RG
higienicamente	higienicamente	RG
hilariantemente	hilariantemente	RG
hiperbolicamente	hiperbolicamente	RG
hipercriticamente	hipercriticamente	RG
hipertroficamente	hipertroficamente	RG
hipicamente	hipicamente	RG
hipocoristicamente	hipocoristicamente	RG
hipocritamente	hipocritamente	RG
hipostaticamente	hipostaticamente	RG
hipotecariamente	hipotecariamente	RG
hipoteticamente	hipoteticamente	RG
hirtamente	hirtamente	RG
hispanicamente	hispanicamente	RG
histericamente	histericamente	RG
historicamente	historicamente	RG
histrionicamente	histrionicamente	RG
hodiernamente	hodiernamente	RG
homericamente	homericamente	RG
homocentricamente	homocentricamente	RG
homofonamente	homofonamente	RG
homofonicamente	homofonicamente	RG
homogeneamente	homogeneamente	RG
homograficamente	homograficamente	RG
homonimamente	homonimamente	RG
homonimicamente	homonimicamente	RG
honestamente	honestamente	RG
honorariamente	honorariamente	RG
honorificamente	honorificamente	RG
honradamente	honradamente	RG
honrosamente	honrosamente	RG
horizontalmente	horizontalmente	RG
horrendamente	horrendamente	RG
horridamente	horridamente	RG
horrificamente	horrificamente	RG
horripilantemente	horripilantemente	RG
horrivelmente	horrivelmente	RG
horrorosamente	horrorosamente	RG
hospitaleiramente	hospitaleiramente	RG
hostilmente	hostilmente	RG
humanamente	humanamente	RG
humanisticamente	humanisticamente	RG
humanitariamente	humanitariamente	RG
humidamente	humidamente	RG
humildemente	humildemente	RG
humildosamente	humildosamente	RG
humilhantemente	humilhantemente	RG
humoristicamente	humoristicamente	RG
iconograficamente	iconograficamente	RG
idealisticamente	idealisticamente	RG
idealmente	idealmente	RG
identicamente	identicamente	RG
ideograficamente	ideograficamente	RG
ideologicamente	ideologicamente	RG
idilicamente	idilicamente	RG
idiomaticamente	idiomaticamente	RG
idiossincrasicamente	idiossincrasicamente	RG
idiossincraticamente	idiossincraticamente	RG
idiotamente	idiotamente	RG
idolatradamente	idolatradamente	RG
idolatricamente	idolatricamente	RG
idoneamente	idoneamente	RG
ignaramente	ignaramente	RG
ignobilmente	ignobilmente	RG
ignominiosamente	ignominiosamente	RG
igualitariamente	igualitariamente	RG
igualmente	igualmente	RG
ilegalmente	ilegalmente	RG
ilegitimamente	ilegitimamente	RG
ilicitamente	ilicitamente	RG
ilimitadamente	ilimitadamente	RG
ilogicamente	ilogicamente	RG
iludivelmente	iludivelmente	RG
ilusoriamente	ilusoriamente	RG
ilustrativamente	ilustrativamente	RG
imageticamente	imageticamente	RG
imaginariamente	imaginariamente	RG
imaginavelmente	imaginavelmente	RG
imaginosamente	imaginosamente	RG
imaterialmente	imaterialmente	RG
imbecilmente	imbecilmente	RG
imediatamente	imediatamente	RG
imensamente	imensamente	RG
imensuravelmente	imensuravelmente	RG
imerecidamente	imerecidamente	RG
imeritamente	imeritamente	RG
imitativamente	imitativamente	RG
imobiliariamente	imobiliariamente	RG
imoderadamente	imoderadamente	RG
imodestamente	imodestamente	RG
imodicamente	imodicamente	RG
imoralmente	imoralmente	RG
imovelmente	imovelmente	RG
impacientemente	impacientemente	RG
impalpavelmente	impalpavelmente	RG
imparcialmente	imparcialmente	RG
impassivelmente	impassivelmente	RG
impatrioticamente	impatrioticamente	RG
impavidamente	impavidamente	RG
impecavelmente	impecavelmente	RG
impeditivamente	impeditivamente	RG
impenetravelmente	impenetravelmente	RG
impensadamente	impensadamente	RG
imperativamente	imperativamente	RG
imperatoriamente	imperatoriamente	RG
imperceptivelmente	imperceptivelmente	RG
impercetivelmente	impercetivelmente	RG
imperdoavelmente	imperdoavelmente	RG
imperecivelmente	imperecivelmente	RG
imperfectivelmente	imperfectivelmente	RG
imperfeitamente	imperfeitamente	RG
imperfetivelmente	imperfetivelmente	RG
imperialmente	imperialmente	RG
imperiosamente	imperiosamente	RG
imperitamente	imperitamente	RG
impermeavelmente	impermeavelmente	RG
imperscrutavelmente	imperscrutavelmente	RG
imperterritamente	imperterritamente	RG
impertinentemente	impertinentemente	RG
imperturbavelmente	imperturbavelmente	RG
impessoalmente	impessoalmente	RG
impetuosamente	impetuosamente	RG
impiamente	impiamente	RG
impiedosamente	impiedosamente	RG
implacavelmente	implacavelmente	RG
implicantemente	implicantemente	RG
implicativamente	implicativamente	RG
implicitamente	implicitamente	RG
implorativamente	implorativamente	RG
impolidamente	impolidamente	RG
impoliticamente	impoliticamente	RG
impolutamente	impolutamente	RG
imponderadamente	imponderadamente	RG
imponderavelmente	imponderavelmente	RG
imponentemente	imponentemente	RG
impopularmente	impopularmente	RG
importunamente	importunamente	RG
impossivelmente	impossivelmente	RG
impotentemente	impotentemente	RG
impraticavelmente	impraticavelmente	RG
imprecativamente	imprecativamente	RG
imprecatoriamente	imprecatoriamente	RG
imprecisamente	imprecisamente	RG
impremeditadamente	impremeditadamente	RG
imprescindivelmente	imprescindivelmente	RG
imprescritivelmente	imprescritivelmente	RG
impressionantemente	impressionantemente	RG
impressivamente	impressivamente	RG
impreterivelmente	impreterivelmente	RG
imprevidentemente	imprevidentemente	RG
imprevisivelmente	imprevisivelmente	RG
imprevistamente	imprevistamente	RG
improcedentemente	improcedentemente	RG
improdutivamente	improdutivamente	RG
improficuamente	improficuamente	RG
improgressivamente	improgressivamente	RG
improporcionalmente	improporcionalmente	RG
impropriamente	impropriamente	RG
improrrogavelmente	improrrogavelmente	RG
improvavelmente	improvavelmente	RG
improvidamente	improvidamente	RG
improvisamente	improvisamente	RG
imprudentemente	imprudentemente	RG
impudentemente	impudentemente	RG
impulsivamente	impulsivamente	RG
impunemente	impunemente	RG
impuramente	impuramente	RG
imundamente	imundamente	RG
imutavelmente	imutavelmente	RG
inabalavelmente	inabalavelmente	RG
inabilmente	inabilmente	RG
inaceitavelmente	inaceitavelmente	RG
inacessivelmente	inacessivelmente	RG
inacreditavelmente	inacreditavelmente	RG
inadequadamente	inadequadamente	RG
inadmissivelmente	inadmissivelmente	RG
inadvertidamente	inadvertidamente	RG
inalteravelmente	inalteravelmente	RG
inapagavelmente	inapagavelmente	RG
inapelavelmente	inapelavelmente	RG
inarmonicamente	inarmonicamente	RG
inativamente	inativamente	RG
inauditamente	inauditamente	RG
inaudivelmente	inaudivelmente	RG
incalculavelmente	incalculavelmente	RG
incansavelmente	incansavelmente	RG
incapazmente	incapazmente	RG
incaracteristicamente	incaracteristicamente	RG
incarateristicamente	incarateristicamente	RG
incautamente	incautamente	RG
incendidamente	incendidamente	RG
incertamente	incertamente	RG
incessantemente	incessantemente	RG
incestuosamente	incestuosamente	RG
inchadamente	inchadamente	RG
incidentalmente	incidentalmente	RG
incidentemente	incidentemente	RG
incisamente	incisamente	RG
incisivamente	incisivamente	RG
incitativamente	incitativamente	RG
incivilmente	incivilmente	RG
inclementemente	inclementemente	RG
inclinadamente	inclinadamente	RG
inclusivamente	inclusivamente	RG
incoerentemente	incoerentemente	RG
incognitamente	incognitamente	RG
incomensuravelmente	incomensuravelmente	RG
incomodamente	incomodamente	RG
incomodativamente	incomodativamente	RG
incomparavelmente	incomparavelmente	RG
incompetentemente	incompetentemente	RG
incompletamente	incompletamente	RG
incomportavelmente	incomportavelmente	RG
incompreensivelmente	incompreensivelmente	RG
incomunicavelmente	incomunicavelmente	RG
incomutavelmente	incomutavelmente	RG
inconcebivelmente	inconcebivelmente	RG
inconciliavelmente	inconciliavelmente	RG
inconcussamente	inconcussamente	RG
incondicionalmente	incondicionalmente	RG
inconexamente	inconexamente	RG
inconfessavelmente	inconfessavelmente	RG
inconfundivelmente	inconfundivelmente	RG
incongruamente	incongruamente	RG
incongruentemente	incongruentemente	RG
inconsciamente	inconsciamente	RG
inconscienciosamente	inconscienciosamente	RG
inconscientemente	inconscientemente	RG
inconsequentemente	inconsequentemente	RG
inconsideradamente	inconsideradamente	RG
inconsistentemente	inconsistentemente	RG
inconsolavelmente	inconsolavelmente	RG
inconstantemente	inconstantemente	RG
inconstitucionalmente	inconstitucionalmente	RG
incontavelmente	incontavelmente	RG
incontestavelmente	incontestavelmente	RG
incontinentemente	incontinentemente	RG
incontrastavelmente	incontrastavelmente	RG
inconvenientemente	inconvenientemente	RG
incorporeamente	incorporeamente	RG
incorretamente	incorretamente	RG
incorrigivelmente	incorrigivelmente	RG
incorruptamente	incorruptamente	RG
incorruptivelmente	incorruptivelmente	RG
incredulamente	incredulamente	RG
incrivelmente	incrivelmente	RG
incruentamente	incruentamente	RG
inculpavelmente	inculpavelmente	RG
inculposamente	inculposamente	RG
incultamente	incultamente	RG
incuravelmente	incuravelmente	RG
incuriosamente	incuriosamente	RG
indecentemente	indecentemente	RG
indecifravelmente	indecifravelmente	RG
indecisamente	indecisamente	RG
indeclinavelmente	indeclinavelmente	RG
indecorosamente	indecorosamente	RG
indefectivelmente	indefectivelmente	RG
indefessamente	indefessamente	RG
indefetivelmente	indefetivelmente	RG
indefinidamente	indefinidamente	RG
indefinivelmente	indefinivelmente	RG
indelevelmente	indelevelmente	RG
indeliberadamente	indeliberadamente	RG
indelicadamente	indelicadamente	RG
independentemente	independentemente	RG
indescritivelmente	indescritivelmente	RG
indesculpavelmente	indesculpavelmente	RG
indesejavelmente	indesejavelmente	RG
indesligavelmente	indesligavelmente	RG
indesmentivelmente	indesmentivelmente	RG
indestrutivelmente	indestrutivelmente	RG
indeterminadamente	indeterminadamente	RG
indevidamente	indevidamente	RG
indevotamente	indevotamente	RG
indianamente	indianamente	RG
indicativamente	indicativamente	RG
indiferentemente	indiferentemente	RG
indigentemente	indigentemente	RG
indignadamente	indignadamente	RG
indignamente	indignamente	RG
indiligentemente	indiligentemente	RG
indinamente	indinamente	RG
indiretamente	indiretamente	RG
indisciplinadamente	indisciplinadamente	RG
indiscretamente	indiscretamente	RG
indiscriminadamente	indiscriminadamente	RG
indiscutivelmente	indiscutivelmente	RG
indispensavelmente	indispensavelmente	RG
indisputavelmente	indisputavelmente	RG
indissociavelmente	indissociavelmente	RG
indissoluvelmente	indissoluvelmente	RG
indistintamente	indistintamente	RG
inditosamente	inditosamente	RG
individualisticamente	individualisticamente	RG
individualmente	individualmente	RG
indivisamente	indivisamente	RG
indivisivelmente	indivisivelmente	RG
indizivelmente	indizivelmente	RG
indocilmente	indocilmente	RG
indolentemente	indolentemente	RG
indomavelmente	indomavelmente	RG
indoutamente	indoutamente	RG
indubitavelmente	indubitavelmente	RG
indulgentemente	indulgentemente	RG
industrialmente	industrialmente	RG
industriosamente	industriosamente	RG
indutivamente	indutivamente	RG
inebriantemente	inebriantemente	RG
inefavelmente	inefavelmente	RG
ineficazmente	ineficazmente	RG
ineficientemente	ineficientemente	RG
inegavelmente	inegavelmente	RG
inelutavelmente	inelutavelmente	RG
inenarravelmente	inenarravelmente	RG
ineptamente	ineptamente	RG
inequitativamente	inequitativamente	RG
inequivocamente	inequivocamente	RG
inerentemente	inerentemente	RG
inertemente	inertemente	RG
inescrupulosamente	inescrupulosamente	RG
inescusavelmente	inescusavelmente	RG
inesgotavelmente	inesgotavelmente	RG
inesitantemente	inesitantemente	RG
inesperadamente	inesperadamente	RG
inesteticamente	inesteticamente	RG
inestimavelmente	inestimavelmente	RG
inevitavelmente	inevitavelmente	RG
inexatamente	inexatamente	RG
inexcedivelmente	inexcedivelmente	RG
inexoravelmente	inexoravelmente	RG
inexplicavelmente	inexplicavelmente	RG
inexpressivamente	inexpressivamente	RG
inexprimivelmente	inexprimivelmente	RG
inextricavelmente	inextricavelmente	RG
infalivelmente	infalivelmente	RG
infamemente	infamemente	RG
infantilmente	infantilmente	RG
infatigavelmente	infatigavelmente	RG
infaustamente	infaustamente	RG
infecciosamente	infecciosamente	RG
infelizmente	infelizmente	RG
inferiormente	inferiormente	RG
infernalmente	infernalmente	RG
infertilmente	infertilmente	RG
infielmente	infielmente	RG
infimamente	infimamente	RG
infindamente	infindamente	RG
infindavelmente	infindavelmente	RG
infinitamente	infinitamente	RG
infinitesimalmente	infinitesimalmente	RG
inflamadamente	inflamadamente	RG
inflexivelmente	inflexivelmente	RG
influentemente	influentemente	RG
informalmente	informalmente	RG
informaticamente	informaticamente	RG
informativamente	informativamente	RG
informemente	informemente	RG
infortunadamente	infortunadamente	RG
infrenemente	infrenemente	RG
infrequentemente	infrequentemente	RG
infrutiferamente	infrutiferamente	RG
infrutuosamente	infrutuosamente	RG
infundadamente	infundadamente	RG
infusamente	infusamente	RG
ingenitamente	ingenitamente	RG
ingenuamente	ingenuamente	RG
inglesmente	inglesmente	RG
ingloriamente	ingloriamente	RG
ingloriosamente	ingloriosamente	RG
ingluviosamente	ingluviosamente	RG
ingraciosamente	ingraciosamente	RG
ingratamente	ingratamente	RG
inibitivamente	inibitivamente	RG
inibitoriamente	inibitoriamente	RG
inicialmente	inicialmente	RG
inigualavelmente	inigualavelmente	RG
iniludivelmente	iniludivelmente	RG
inimaginavelmente	inimaginavelmente	RG
inimitavelmente	inimitavelmente	RG
ininteligentemente	ininteligentemente	RG
ininteligivelmente	ininteligivelmente	RG
inintencionalmente	inintencionalmente	RG
ininterrompidamente	ininterrompidamente	RG
ininterruptamente	ininterruptamente	RG
iniquamente	iniquamente	RG
injuriosamente	injuriosamente	RG
injustamente	injustamente	RG
injustificadamente	injustificadamente	RG
inocentemente	inocentemente	RG
inocuamente	inocuamente	RG
inofensivamente	inofensivamente	RG
inoficiosamente	inoficiosamente	RG
inonestamente	inonestamente	RG
inopinadamente	inopinadamente	RG
inoportunamente	inoportunamente	RG
inorganicamente	inorganicamente	RG
inospitaleiramente	inospitaleiramente	RG
inquebrantavelmente	inquebrantavelmente	RG
inquestionavelmente	inquestionavelmente	RG
inquietadoramente	inquietadoramente	RG
inquietamente	inquietamente	RG
inquisitorialmente	inquisitorialmente	RG
insaciavelmente	insaciavelmente	RG
insalubremente	insalubremente	RG
insanamente	insanamente	RG
insanavelmente	insanavelmente	RG
insaturavelmente	insaturavelmente	RG
inscientemente	inscientemente	RG
inseguramente	inseguramente	RG
insensatamente	insensatamente	RG
insensivelmente	insensivelmente	RG
inseparavelmente	inseparavelmente	RG
insidiosamente	insidiosamente	RG
insignemente	insignemente	RG
insignificantemente	insignificantemente	RG
insinuantemente	insinuantemente	RG
insipidamente	insipidamente	RG
insistentemente	insistentemente	RG
insociavelmente	insociavelmente	RG
insofismavelmente	insofismavelmente	RG
insofridamente	insofridamente	RG
insofrivelmente	insofrivelmente	RG
insolentemente	insolentemente	RG
insolitamente	insolitamente	RG
insoluvelmente	insoluvelmente	RG
insondavelmente	insondavelmente	RG
insonsamente	insonsamente	RG
insossamente	insossamente	RG
inspiradamente	inspiradamente	RG
instantaneamente	instantaneamente	RG
instantemente	instantemente	RG
instavelmente	instavelmente	RG
instintivamente	instintivamente	RG
institucionalmente	institucionalmente	RG
instrumentalmente	instrumentalmente	RG
instrutivamente	instrutivamente	RG
insubmissamente	insubmissamente	RG
insubordinadamente	insubordinadamente	RG
insuficientemente	insuficientemente	RG
insulanamente	insulanamente	RG
insulsamente	insulsamente	RG
insultuosamente	insultuosamente	RG
insuperavelmente	insuperavelmente	RG
insuportavelmente	insuportavelmente	RG
insurreccionalmente	insurreccionalmente	RG
insurrecionalmente	insurrecionalmente	RG
insuspeitamente	insuspeitamente	RG
insuspeitavelmente	insuspeitavelmente	RG
insuspeitosamente	insuspeitosamente	RG
insustentavelmente	insustentavelmente	RG
intangivelmente	intangivelmente	RG
integerrimamente	integerrimamente	RG
integralmente	integralmente	RG
integramente	integramente	RG
inteiramente	inteiramente	RG
inteiriçamente	inteiriçamente	RG
intelectivamente	intelectivamente	RG
intelectualmente	intelectualmente	RG
inteligentemente	inteligentemente	RG
inteligivelmente	inteligivelmente	RG
intemeratamente	intemeratamente	RG
intemperadamente	intemperadamente	RG
intempestivamente	intempestivamente	RG
intemporalmente	intemporalmente	RG
intencionalmente	intencionalmente	RG
intensamente	intensamente	RG
intensivamente	intensivamente	RG
intercorrentemente	intercorrentemente	RG
interdentalmente	interdentalmente	RG
interessadamente	interessadamente	RG
interesseiramente	interesseiramente	RG
interinamente	interinamente	RG
interiormente	interiormente	RG
interjectivamente	interjectivamente	RG
interjetivamente	interjetivamente	RG
interlocutoriamente	interlocutoriamente	RG
intermediariamente	intermediariamente	RG
interminavelmente	interminavelmente	RG
intermitentemente	intermitentemente	RG
internacionalmente	internacionalmente	RG
internamente	internamente	RG
interplanetariamente	interplanetariamente	RG
interpoladamente	interpoladamente	RG
interpretativamente	interpretativamente	RG
interrogadoramente	interrogadoramente	RG
interrogativamente	interrogativamente	RG
interruptamente	interruptamente	RG
intervaladamente	intervaladamente	RG
intervalarmente	intervalarmente	RG
interventivamente	interventivamente	RG
intimamente	intimamente	RG
intimativamente	intimativamente	RG
intimidativamente	intimidativamente	RG
intimoratamente	intimoratamente	RG
intolerantemente	intolerantemente	RG
intoleravelmente	intoleravelmente	RG
intranquilamente	intranquilamente	RG
intransigentemente	intransigentemente	RG
intransitivamente	intransitivamente	RG
intransmissivelmente	intransmissivelmente	RG
intrepidamente	intrepidamente	RG
intricadamente	intricadamente	RG
intrincadamente	intrincadamente	RG
intrinsecamente	intrinsecamente	RG
introdutivamente	introdutivamente	RG
introdutoriamente	introdutoriamente	RG
introspetivamente	introspetivamente	RG
intrusamente	intrusamente	RG
intuitivamente	intuitivamente	RG
intuspectivamente	intuspectivamente	RG
intuspetivamente	intuspetivamente	RG
inumanamente	inumanamente	RG
inumeravelmente	inumeravelmente	RG
inurbanamente	inurbanamente	RG
inusitadamente	inusitadamente	RG
inutilmente	inutilmente	RG
invalidamente	invalidamente	RG
invariavelmente	invariavelmente	RG
invejavelmente	invejavelmente	RG
invejosamente	invejosamente	RG
invencivelmente	invencivelmente	RG
inverisimilmente	inverisimilmente	RG
inverosimilmente	inverosimilmente	RG
inversamente	inversamente	RG
inveteradamente	inveteradamente	RG
inviolavelmente	inviolavelmente	RG
invirilmente	invirilmente	RG
invisivelmente	invisivelmente	RG
invocativamente	invocativamente	RG
invocatoriamente	invocatoriamente	RG
involuntariamente	involuntariamente	RG
invulgarmente	invulgarmente	RG
invulneravelmente	invulneravelmente	RG
ionicamente	ionicamente	RG
iracundamente	iracundamente	RG
iradamente	iradamente	RG
irmãmente	irmãmente	RG
ironicamente	ironicamente	RG
irracionalmente	irracionalmente	RG
irracionavelmente	irracionavelmente	RG
irrealmente	irrealmente	RG
irreconciliavelmente	irreconciliavelmente	RG
irrecuperavelmente	irrecuperavelmente	RG
irrecusavelmente	irrecusavelmente	RG
irredutivelmente	irredutivelmente	RG
irrefletidamente	irrefletidamente	RG
irreflexivamente	irreflexivamente	RG
irrefragavelmente	irrefragavelmente	RG
irrefutavelmente	irrefutavelmente	RG
irregularmente	irregularmente	RG
irremediavelmente	irremediavelmente	RG
irremissivelmente	irremissivelmente	RG
irreparavelmente	irreparavelmente	RG
irreplicavelmente	irreplicavelmente	RG
irrepreensivelmente	irrepreensivelmente	RG
irreprimivelmente	irreprimivelmente	RG
irresistivelmente	irresistivelmente	RG
irresolutamente	irresolutamente	RG
irrespeitosamente	irrespeitosamente	RG
irrespondivelmente	irrespondivelmente	RG
irresponsavelmente	irresponsavelmente	RG
irrestritamente	irrestritamente	RG
irretratavelmente	irretratavelmente	RG
irreverenciosamente	irreverenciosamente	RG
irreverentemente	irreverentemente	RG
irreversivelmente	irreversivelmente	RG
irrevogavelmente	irrevogavelmente	RG
irrisoriamente	irrisoriamente	RG
irritamente	irritamente	RG
irritantemente	irritantemente	RG
irrivalizavelmente	irrivalizavelmente	RG
irruptivamente	irruptivamente	RG
isentamente	isentamente	RG
isocronamente	isocronamente	RG
isocronicamente	isocronicamente	RG
isoladamente	isoladamente	RG
isotermicamente	isotermicamente	RG
iterativamente	iterativamente	RG
jacobinamente	jacobinamente	RG
jactanciosamente	jactanciosamente	RG
japonicamente	japonicamente	RG
jeitosamente	jeitosamente	RG
jerarquicamente	jerarquicamente	RG
jesuiticamente	jesuiticamente	RG
jocosamente	jocosamente	RG
jonicamente	jonicamente	RG
jornalisticamente	jornalisticamente	RG
jovialmente	jovialmente	RG
jubilosamente	jubilosamente	RG
jucundamente	jucundamente	RG
judaicamente	judaicamente	RG
judicialmente	judicialmente	RG
judiciariamente	judiciariamente	RG
judiciosamente	judiciosamente	RG
juntamente	juntamente	RG
juridicamente	juridicamente	RG
justalinearmente	justalinearmente	RG
justamente	justamente	RG
justiceiramente	justiceiramente	RG
justificadamente	justificadamente	RG
juvenilmente	juvenilmente	RG
laboratorialmente	laboratorialmente	RG
laboriosamente	laboriosamente	RG
laconicamente	laconicamente	RG
lamentavelmente	lamentavelmente	RG
languidamente	languidamente	RG
largamente	largamente	RG
lascivamente	lascivamente	RG
lastimavelmente	lastimavelmente	RG
lateralmente	lateralmente	RG
latitudinalmente	latitudinalmente	RG
laudativamente	laudativamente	RG
lautamente	lautamente	RG
lealmente	lealmente	RG
ledamente	ledamente	RG
legalmente	legalmente	RG
legislativamente	legislativamente	RG
legitimamente	legitimamente	RG
legivelmente	legivelmente	RG
lendariamente	lendariamente	RG
lenitivamente	lenitivamente	RG
lentamente	lentamente	RG
lentissimamente	lentissimamente	RG
lepidamente	lepidamente	RG
lerdamente	lerdamente	RG
lestamente	lestamente	RG
letalmente	letalmente	RG
letargicamente	letargicamente	RG
levemente	levemente	RG
levianamente	levianamente	RG
lexicalmente	lexicalmente	RG
lexicograficamente	lexicograficamente	RG
lexicologicamente	lexicologicamente	RG
lhanamente	lhanamente	RG
libentemente	libentemente	RG
liberalmente	liberalmente	RG
libertinamente	libertinamente	RG
libidinosamente	libidinosamente	RG
licealmente	licealmente	RG
licenciosamente	licenciosamente	RG
licitamente	licitamente	RG
lidimamente	lidimamente	RG
ligeiramente	ligeiramente	RG
liminarmente	liminarmente	RG
limitadamente	limitadamente	RG
limitativamente	limitativamente	RG
limpamente	limpamente	RG
limpidamente	limpidamente	RG
lindamente	lindamente	RG
linearmente	linearmente	RG
linguisticamente	linguisticamente	RG
liricamente	liricamente	RG
lisamente	lisamente	RG
lisonjeiramente	lisonjeiramente	RG
literalmente	literalmente	RG
literariamente	literariamente	RG
litigiosamente	litigiosamente	RG
litograficamente	litograficamente	RG
liturgicamente	liturgicamente	RG
lividamente	lividamente	RG
livremente	livremente	RG
lobregamente	lobregamente	RG
localmente	localmente	RG
logicamente	logicamente	RG
logisticamente	logisticamente	RG
logrativamente	logrativamente	RG
longamente	longamente	RG
longanimamente	longanimamente	RG
longanimemente	longanimemente	RG
longinquamente	longinquamente	RG
longitudinalmente	longitudinalmente	RG
loquazmente	loquazmente	RG
loucamente	loucamente	RG
louvavelmente	louvavelmente	RG
lubricamente	lubricamente	RG
lucidamente	lucidamente	RG
lucrativamente	lucrativamente	RG
luculentamente	luculentamente	RG
lugentemente	lugentemente	RG
lugubremente	lugubremente	RG
luminosamente	luminosamente	RG
lunaticamente	lunaticamente	RG
lusitanamente	lusitanamente	RG
lusitanicamente	lusitanicamente	RG
luso-brasileiramente	luso-brasileiramente	RG
lustrosamente	lustrosamente	RG
luxuosamente	luxuosamente	RG
luxuriantemente	luxuriantemente	RG
luxuriosamente	luxuriosamente	RG
luzidamente	luzidamente	RG
macabramente	macabramente	RG
macarronicamente	macarronicamente	RG
maciamente	maciamente	RG
maciçamente	maciçamente	RG
macroscopicamente	macroscopicamente	RG
maduramente	maduramente	RG
magicamente	magicamente	RG
magistralmente	magistralmente	RG
magnanimamente	magnanimamente	RG
magneticamente	magneticamente	RG
magnificamente	magnificamente	RG
magnificentemente	magnificentemente	RG
magoadamente	magoadamente	RG
magramente	magramente	RG
maieuticamente	maieuticamente	RG
maioritariamente	maioritariamente	RG
maiormente	maiormente	RG
maiusculamente	maiusculamente	RG
majestaticamente	majestaticamente	RG
majestosamente	majestosamente	RG
mal-afortunadamente	mal-afortunadamente	RG
mal-ajeitadamente	mal-ajeitadamente	RG
mal-assombradamente	mal-assombradamente	RG
mal-aventuradamente	mal-aventuradamente	RG
mal-educadamente	mal-educadamente	RG
mal-encaradamente	mal-encaradamente	RG
mal-humoradamente	mal-humoradamente	RG
mal-intencionadamente	mal-intencionadamente	RG
malcriadamente	malcriadamente	RG
maldosamente	maldosamente	RG
maleavelmente	maleavelmente	RG
maleficamente	maleficamente	RG
malevolamente	malevolamente	RG
malfadadamente	malfadadamente	RG
maliciosamente	maliciosamente	RG
malignamente	malignamente	RG
malissimamente	malissimamente	RG
maljeitosamente	maljeitosamente	RG
malogradamente	malogradamente	RG
malvadamente	malvadamente	RG
malventurosamente	malventurosamente	RG
mamente	mamente	RG
mancomunadamente	mancomunadamente	RG
manhosamente	manhosamente	RG
maniacamente	maniacamente	RG
manifestamente	manifestamente	RG
mansamente	mansamente	RG
manualmente	manualmente	RG
maquiavelicamente	maquiavelicamente	RG
maquinalmente	maquinalmente	RG
maravilhosamente	maravilhosamente	RG
marcadamente	marcadamente	RG
marcialmente	marcialmente	RG
marginalmente	marginalmente	RG
marinhaticamente	marinhaticamente	RG
maritalmente	maritalmente	RG
masculamente	masculamente	RG
masculinamente	masculinamente	RG
massivamente	massivamente	RG
matematicamente	matematicamente	RG
materialmente	materialmente	RG
maternalmente	maternalmente	RG
maternamente	maternamente	RG
matinalmente	matinalmente	RG
matreiramente	matreiramente	RG
matrimonialmente	matrimonialmente	RG
maviosamente	maviosamente	RG
maximamente	maximamente	RG
maçonicamente	maçonicamente	RG
maçudamente	maçudamente	RG
mecanicamente	mecanicamente	RG
mecenaticamente	mecenaticamente	RG
medialmente	medialmente	RG
medianamente	medianamente	RG
mediatamente	mediatamente	RG
mediaticamente	mediaticamente	RG
medicamente	medicamente	RG
medicinalmente	medicinalmente	RG
medidamente	medidamente	RG
mediocremente	mediocremente	RG
meditadamente	meditadamente	RG
meditativamente	meditativamente	RG
medonhamente	medonhamente	RG
medrosamente	medrosamente	RG
medularmente	medularmente	RG
mefistofelicamente	mefistofelicamente	RG
mefiticamente	mefiticamente	RG
meigamente	meigamente	RG
melancolicamente	melancolicamente	RG
melhoradamente	melhoradamente	RG
melhormente	melhormente	RG
melicamente	melicamente	RG
melifluamente	melifluamente	RG
melindrosamente	melindrosamente	RG
meliorativamente	meliorativamente	RG
melodicamente	melodicamente	RG
melodiosamente	melodiosamente	RG
melodramaticamente	melodramaticamente	RG
melograficamente	melograficamente	RG
memoravelmente	memoravelmente	RG
mensalmente	mensalmente	RG
mentalmente	mentalmente	RG
mentirosamente	mentirosamente	RG
meramente	meramente	RG
mercantilmente	mercantilmente	RG
mercenariamente	mercenariamente	RG
merecidamente	merecidamente	RG
merencoriamente	merencoriamente	RG
meritamente	meritamente	RG
meritoriamente	meritoriamente	RG
mesmamente	mesmamente	RG
mesologicamente	mesologicamente	RG
mesquinhamente	mesquinhamente	RG
mesuradamente	mesuradamente	RG
metafisicamente	metafisicamente	RG
metafonicamente	metafonicamente	RG
metaforicamente	metaforicamente	RG
metalicamente	metalicamente	RG
meteoricamente	meteoricamente	RG
meticulosamente	meticulosamente	RG
metodicamente	metodicamente	RG
metodologicamente	metodologicamente	RG
metonimicamente	metonimicamente	RG
metricamente	metricamente	RG
micrometricamente	micrometricamente	RG
microscopicamente	microscopicamente	RG
milagrosamente	milagrosamente	RG
milimetricamente	milimetricamente	RG
militantemente	militantemente	RG
militarmente	militarmente	RG
mimeticamente	mimeticamente	RG
mimicamente	mimicamente	RG
mimosamente	mimosamente	RG
mineralogicamente	mineralogicamente	RG
minguadamente	minguadamente	RG
miniaturalmente	miniaturalmente	RG
minimamente	minimamente	RG
ministerialmente	ministerialmente	RG
minorativamente	minorativamente	RG
minoritariamente	minoritariamente	RG
minuciosamente	minuciosamente	RG
minudenciosamente	minudenciosamente	RG
minudentemente	minudentemente	RG
minusculamente	minusculamente	RG
mirabolantemente	mirabolantemente	RG
miraculosamente	miraculosamente	RG
mirificamente	mirificamente	RG
mirradamente	mirradamente	RG
misantropicamente	misantropicamente	RG
miseramente	miseramente	RG
miserandamente	miserandamente	RG
miseravelmente	miseravelmente	RG
misericordiosamente	misericordiosamente	RG
misteriosamente	misteriosamente	RG
misticamente	misticamente	RG
miticamente	miticamente	RG
mitologicamente	mitologicamente	RG
miudamente	miudamente	RG
mnemonicamente	mnemonicamente	RG
modelarmente	modelarmente	RG
moderadamente	moderadamente	RG
modernamente	modernamente	RG
modestamente	modestamente	RG
modicamente	modicamente	RG
mofinamente	mofinamente	RG
moiriscamente	moiriscamente	RG
molecularmente	molecularmente	RG
molemente	molemente	RG
molestamente	molestamente	RG
momentaneamente	momentaneamente	RG
monacalmente	monacalmente	RG
monarquicamente	monarquicamente	RG
monasticamente	monasticamente	RG
monetariamente	monetariamente	RG
monoconcordicamente	monoconcordicamente	RG
monocordicamente	monocordicamente	RG
monodicamente	monodicamente	RG
monograficamente	monograficamente	RG
monossilabicamente	monossilabicamente	RG
monotonamente	monotonamente	RG
monstruosamente	monstruosamente	RG
monumentalmente	monumentalmente	RG
moralmente	moralmente	RG
morbidamente	morbidamente	RG
mordazmente	mordazmente	RG
morfologicamente	morfologicamente	RG
morganaticamente	morganaticamente	RG
mormente	mormente	RG
morosamente	morosamente	RG
mortalmente	mortalmente	RG
mouriscamente	mouriscamente	RG
movimentadamente	movimentadamente	RG
mudamente	mudamente	RG
mulherilmente	mulherilmente	RG
multiformemente	multiformemente	RG
multiplamente	multiplamente	RG
mundanalmente	mundanalmente	RG
mundanamente	mundanamente	RG
mundialmente	mundialmente	RG
municipalmente	municipalmente	RG
munificentemente	munificentemente	RG
muscularmente	muscularmente	RG
musicalmente	musicalmente	RG
musicamente	musicamente	RG
mutualmente	mutualmente	RG
mutuamente	mutuamente	RG
muçulmanamente	muçulmanamente	RG
nacionalisticamente	nacionalisticamente	RG
nacionalmente	nacionalmente	RG
namoradamente	namoradamente	RG
napoleonicamente	napoleonicamente	RG
narrativamente	narrativamente	RG
nasalmente	nasalmente	RG
naturalisticamente	naturalisticamente	RG
naturalmente	naturalmente	RG
nauseosamente	nauseosamente	RG
navalmente	navalmente	RG
nebulosamente	nebulosamente	RG
necessariamente	necessariamente	RG
nectareamente	nectareamente	RG
nefandamente	nefandamente	RG
nefariamente	nefariamente	RG
nefastamente	nefastamente	RG
nefelibaticamente	nefelibaticamente	RG
negativamente	negativamente	RG
negligentemente	negligentemente	RG
negociosamente	negociosamente	RG
neologicamente	neologicamente	RG
nervosamente	nervosamente	RG
nesciamente	nesciamente	RG
neutralmente	neutralmente	RG
nimiamente	nimiamente	RG
nitidamente	nitidamente	RG
nobiliarquicamente	nobiliarquicamente	RG
nobremente	nobremente	RG
nocivamente	nocivamente	RG
nojentamente	nojentamente	RG
nojosamente	nojosamente	RG
nomeadamente	nomeadamente	RG
nominalmente	nominalmente	RG
normalmente	normalmente	RG
normativamente	normativamente	RG
nostalgicamente	nostalgicamente	RG
notadamente	notadamente	RG
notarialmente	notarialmente	RG
notavelmente	notavelmente	RG
noticiosamente	noticiosamente	RG
notoriamente	notoriamente	RG
noturnamente	noturnamente	RG
novamente	novamente	RG
novelisticamente	novelisticamente	RG
nuamente	nuamente	RG
nulamente	nulamente	RG
numeralmente	numeralmente	RG
numericamente	numericamente	RG
numerosamente	numerosamente	RG
numismaticamente	numismaticamente	RG
nuncupativamente	nuncupativamente	RG
nutridamente	nutridamente	RG
nutritivamente	nutritivamente	RG
ob-repticiamente	ob-repticiamente	RG
obcecadamente	obcecadamente	RG
obedientemente	obedientemente	RG
obfirmadamente	obfirmadamente	RG
objectivamente	objectivamente	RG
objetivamente	objetivamente	RG
oblativamente	oblativamente	RG
obliquamente	obliquamente	RG
obrigatoriamente	obrigatoriamente	RG
obscenamente	obscenamente	RG
obscuramente	obscuramente	RG
obsequiosamente	obsequiosamente	RG
obsessivamente	obsessivamente	RG
obstinadamente	obstinadamente	RG
obtusamente	obtusamente	RG
obviamente	obviamente	RG
ocamente	ocamente	RG
ocasionalmente	ocasionalmente	RG
ocidentalmente	ocidentalmente	RG
ociosamente	ociosamente	RG
ocularmente	ocularmente	RG
ocultamente	ocultamente	RG
ocupadamente	ocupadamente	RG
odiosamente	odiosamente	RG
ofensivamente	ofensivamente	RG
oficialmente	oficialmente	RG
oficiosamente	oficiosamente	RG
olfactivamente	olfactivamente	RG
olfativamente	olfativamente	RG
oligarquicamente	oligarquicamente	RG
olimpicamente	olimpicamente	RG
ominosamente	ominosamente	RG
omnimodamente	omnimodamente	RG
omnipotentemente	omnipotentemente	RG
ondulatoriamente	ondulatoriamente	RG
ondulosamente	ondulosamente	RG
onerosamente	onerosamente	RG
onomasticamente	onomasticamente	RG
onomatopaicamente	onomatopaicamente	RG
onomatopeicamente	onomatopeicamente	RG
ontologicamente	ontologicamente	RG
opacamente	opacamente	RG
operatoriamente	operatoriamente	RG
operosamente	operosamente	RG
opiniaticamente	opiniaticamente	RG
opiniosamente	opiniosamente	RG
opiparamente	opiparamente	RG
oportunamente	oportunamente	RG
opostamente	opostamente	RG
opressivamente	opressivamente	RG
oprobriosamente	oprobriosamente	RG
optativamente	optativamente	RG
optimamente	optimamente	RG
opulentamente	opulentamente	RG
oracionalmente	oracionalmente	RG
oracularmente	oracularmente	RG
oralmente	oralmente	RG
oratoriamente	oratoriamente	RG
orbicularmente	orbicularmente	RG
ordeiramente	ordeiramente	RG
ordenadamente	ordenadamente	RG
ordinariamente	ordinariamente	RG
organicamente	organicamente	RG
organizadamente	organizadamente	RG
orgulhosamente	orgulhosamente	RG
orientalmente	orientalmente	RG
originalmente	originalmente	RG
originariamente	originariamente	RG
ornamentalmente	ornamentalmente	RG
orquestralmente	orquestralmente	RG
ortodoxamente	ortodoxamente	RG
ortoepicamente	ortoepicamente	RG
ortofonicamente	ortofonicamente	RG
ortogonalmente	ortogonalmente	RG
ortograficamente	ortograficamente	RG
osmoticamente	osmoticamente	RG
ostensivamente	ostensivamente	RG
ostentosamente	ostentosamente	RG
otimamente	otimamente	RG
ousadamente	ousadamente	RG
ovantemente	ovantemente	RG
pacatamente	pacatamente	RG
pachorrentamente	pachorrentamente	RG
pacientemente	pacientemente	RG
pacificamente	pacificamente	RG
pacoviamente	pacoviamente	RG
paisagisticamente	paisagisticamente	RG
palacianamente	palacianamente	RG
palavrosamente	palavrosamente	RG
paleograficamente	paleograficamente	RG
palidamente	palidamente	RG
palonçamente	palonçamente	RG
palpavelmente	palpavelmente	RG
palpitantemente	palpitantemente	RG
pandemicamente	pandemicamente	RG
panoramicamente	panoramicamente	RG
pantagruelicamente	pantagruelicamente	RG
panteistamente	panteistamente	RG
parabolicamente	parabolicamente	RG
paradigmaticamente	paradigmaticamente	RG
paradisiacamente	paradisiacamente	RG
paradoxalmente	paradoxalmente	RG
parafrasticamente	parafrasticamente	RG
paragogicamente	paragogicamente	RG
paralacticamente	paralacticamente	RG
paralaticamente	paralaticamente	RG
paralelamente	paralelamente	RG
paralelisticamente	paralelisticamente	RG
paralogicamente	paralogicamente	RG
parasitariamente	parasitariamente	RG
parasiticamente	parasiticamente	RG
parcamente	parcamente	RG
parcelarmente	parcelarmente	RG
parcialmente	parcialmente	RG
parcimoniosamente	parcimoniosamente	RG
parecidamente	parecidamente	RG
parelhamente	parelhamente	RG
parenteticamente	parenteticamente	RG
parlamentarmente	parlamentarmente	RG
parodicamente	parodicamente	RG
participialmente	participialmente	RG
particularmente	particularmente	RG
partidariamente	partidariamente	RG
partitivamente	partitivamente	RG
parvamente	parvamente	RG
parvoamente	parvoamente	RG
pasmadamente	pasmadamente	RG
pasmosamente	pasmosamente	RG
passageiramente	passageiramente	RG
passionalmente	passionalmente	RG
passivamente	passivamente	RG
paternalmente	paternalmente	RG
pateticamente	pateticamente	RG
patologicamente	patologicamente	RG
patriarcalmente	patriarcalmente	RG
patrimonialmente	patrimonialmente	RG
patrioteiramente	patrioteiramente	RG
patrioticamente	patrioticamente	RG
paulatinamente	paulatinamente	RG
pausadamente	pausadamente	RG
pavidamente	pavidamente	RG
pavorosamente	pavorosamente	RG
pecamente	pecamente	RG
pecaminosamente	pecaminosamente	RG
peculiarmente	peculiarmente	RG
pecuniariamente	pecuniariamente	RG
pedagogicamente	pedagogicamente	RG
pedantescamente	pedantescamente	RG
pedestremente	pedestremente	RG
pejorativamente	pejorativamente	RG
penadamente	penadamente	RG
penalizantemente	penalizantemente	RG
penalmente	penalmente	RG
pendularmente	pendularmente	RG
penetrantemente	penetrantemente	RG
penhoradamente	penhoradamente	RG
penhorantemente	penhorantemente	RG
penosamente	penosamente	RG
pensadamente	pensadamente	RG
pensativamente	pensativamente	RG
perceptivamente	perceptivamente	RG
perceptivelmente	perceptivelmente	RG
percetivamente	percetivamente	RG
percetivelmente	percetivelmente	RG
perdidamente	perdidamente	RG
perdulariamente	perdulariamente	RG
perduravelmente	perduravelmente	RG
peregrinamente	peregrinamente	RG
peremptoriamente	peremptoriamente	RG
perenalmente	perenalmente	RG
perenemente	perenemente	RG
perentoriamente	perentoriamente	RG
perfeitamente	perfeitamente	RG
perfidamente	perfidamente	RG
perfunctoriamente	perfunctoriamente	RG
perfuntoriamente	perfuntoriamente	RG
periclitantemente	periclitantemente	RG
perifericamente	perifericamente	RG
perifrasticamente	perifrasticamente	RG
perigosamente	perigosamente	RG
periodicamente	periodicamente	RG
peripateticamente	peripateticamente	RG
perjuramente	perjuramente	RG
permanentemente	permanentemente	RG
permissivamente	permissivamente	RG
permissivelmente	permissivelmente	RG
perniciosamente	perniciosamente	RG
perpendicularmente	perpendicularmente	RG
perpetuamente	perpetuamente	RG
perplexamente	perplexamente	RG
perramente	perramente	RG
perseverantemente	perseverantemente	RG
persistentemente	persistentemente	RG
personativamente	personativamente	RG
perspicazmente	perspicazmente	RG
perspicuamente	perspicuamente	RG
persuasivamente	persuasivamente	RG
persuasoriamente	persuasoriamente	RG
pertinazmente	pertinazmente	RG
pertinentemente	pertinentemente	RG
perturbadoramente	perturbadoramente	RG
perversamente	perversamente	RG
pervicazmente	pervicazmente	RG
pesadamente	pesadamente	RG
pesarosamente	pesarosamente	RG
pessimamente	pessimamente	RG
pessoalmente	pessoalmente	RG
pestiferamente	pestiferamente	RG
pestilencialmente	pestilencialmente	RG
petulantemente	petulantemente	RG
piamente	piamente	RG
picaramente	picaramente	RG
picarescamente	picarescamente	RG
pictoricamente	pictoricamente	RG
picturalmente	picturalmente	RG
piedosamente	piedosamente	RG
piegasmente	piegasmente	RG
pifiamente	pifiamente	RG
pindaricamente	pindaricamente	RG
pindericamente	pindericamente	RG
pinguemente	pinguemente	RG
pinturescamente	pinturescamente	RG
piormente	piormente	RG
piramidalmente	piramidalmente	RG
pirronicamente	pirronicamente	RG
pitagoricamente	pitagoricamente	RG
pitorescamente	pitorescamente	RG
placidamente	placidamente	RG
planamente	planamente	RG
planetariamente	planetariamente	RG
plangentemente	plangentemente	RG
plasticamente	plasticamente	RG
platonicamente	platonicamente	RG
plausivelmente	plausivelmente	RG
plebeiamente	plebeiamente	RG
plenamente	plenamente	RG
plenariamente	plenariamente	RG
pleonasticamente	pleonasticamente	RG
pletoricamente	pletoricamente	RG
plutocraticamente	plutocraticamente	RG
pobremente	pobremente	RG
poderosamente	poderosamente	RG
poeticamente	poeticamente	RG
polemicamente	polemicamente	RG
polemisticamente	polemisticamente	RG
policialmente	policialmente	RG
polidamente	polidamente	RG
polifonicamente	polifonicamente	RG
poligloticamente	poligloticamente	RG
poligraficamente	poligraficamente	RG
polimorficamente	polimorficamente	RG
polirritmicamente	polirritmicamente	RG
politecnicamente	politecnicamente	RG
politicamente	politicamente	RG
pomposamente	pomposamente	RG
ponderadamente	ponderadamente	RG
ponderosamente	ponderosamente	RG
pontualmente	pontualmente	RG
popularmente	popularmente	RG
porcamente	porcamente	RG
porfiadamente	porfiadamente	RG
porfiosamente	porfiosamente	RG
pormenorizadamente	pormenorizadamente	RG
pornograficamente	pornograficamente	RG
portentosamente	portentosamente	RG
portuguesmente	portuguesmente	RG
positivamente	positivamente	RG
pospositivamente	pospositivamente	RG
possivelmente	possivelmente	RG
posteriormente	posteriormente	RG
postiçamente	postiçamente	RG
postumamente	postumamente	RG
potencialmente	potencialmente	RG
potentemente	potentemente	RG
praceiramente	praceiramente	RG
pragmaticamente	pragmaticamente	RG
praticamente	praticamente	RG
pravamente	pravamente	RG
prazenteiramente	prazenteiramente	RG
prazerosamente	prazerosamente	RG
preambularmente	preambularmente	RG
precariamente	precariamente	RG
precatadamente	precatadamente	RG
precatoriamente	precatoriamente	RG
precavidamente	precavidamente	RG
precedentemente	precedentemente	RG
preceptivamente	preceptivamente	RG
precetivamente	precetivamente	RG
preciosamente	preciosamente	RG
precipitadamente	precipitadamente	RG
precipitosamente	precipitosamente	RG
precipuamente	precipuamente	RG
precisamente	precisamente	RG
preclaramente	preclaramente	RG
precocemente	precocemente	RG
preconcebidamente	preconcebidamente	RG
preconceituosamente	preconceituosamente	RG
predicativamente	predicativamente	RG
prediletamente	prediletamente	RG
predominantemente	predominantemente	RG
preferencialmente	preferencialmente	RG
preferentemente	preferentemente	RG
preferivelmente	preferivelmente	RG
prefixamente	prefixamente	RG
preguiçosamente	preguiçosamente	RG
prejudicialmente	prejudicialmente	RG
preliminarmente	preliminarmente	RG
prematuramente	prematuramente	RG
premeditadamente	premeditadamente	RG
premonitoriamente	premonitoriamente	RG
preparatoriamente	preparatoriamente	RG
preponderantemente	preponderantemente	RG
prepositivamente	prepositivamente	RG
prepotentemente	prepotentemente	RG
presencialmente	presencialmente	RG
presentaneamente	presentaneamente	RG
presentemente	presentemente	RG
pressagamente	pressagamente	RG
pressagiosamente	pressagiosamente	RG
pressurosamente	pressurosamente	RG
prestadiamente	prestadiamente	RG
prestamente	prestamente	RG
prestemente	prestemente	RG
prestesmente	prestesmente	RG
prestigiosamente	prestigiosamente	RG
prestimosamente	prestimosamente	RG
presumidamente	presumidamente	RG
presumivelmente	presumivelmente	RG
presuntivamente	presuntivamente	RG
presuntuosamente	presuntuosamente	RG
presunçosamente	presunçosamente	RG
pretensamente	pretensamente	RG
pretensiosamente	pretensiosamente	RG
prevenidamente	prevenidamente	RG
preventivamente	preventivamente	RG
previamente	previamente	RG
previdentemente	previdentemente	RG
previsivelmente	previsivelmente	RG
previstamente	previstamente	RG
primacialmente	primacialmente	RG
primariamente	primariamente	RG
primaverilmente	primaverilmente	RG
primeiramente	primeiramente	RG
primitivamente	primitivamente	RG
primordialmente	primordialmente	RG
primorosamente	primorosamente	RG
principalmente	principalmente	RG
prioritariamente	prioritariamente	RG
privadamente	privadamente	RG
privativamente	privativamente	RG
privilegiadamente	privilegiadamente	RG
probabilisticamente	probabilisticamente	RG
probamente	probamente	RG
problematicamente	problematicamente	RG
processionalmente	processionalmente	RG
processualmente	processualmente	RG
procliticamente	procliticamente	RG
prodigamente	prodigamente	RG
prodigiosamente	prodigiosamente	RG
produtivamente	produtivamente	RG
proeminentemente	proeminentemente	RG
profanamente	profanamente	RG
profeticamente	profeticamente	RG
proficientemente	proficientemente	RG
proficuamente	proficuamente	RG
profilacticamente	profilacticamente	RG
profilaticamente	profilaticamente	RG
profissionalmente	profissionalmente	RG
profundamente	profundamente	RG
profusamente	profusamente	RG
programaticamente	programaticamente	RG
progressivamente	progressivamente	RG
proibitivamente	proibitivamente	RG
proibitoriamente	proibitoriamente	RG
prolepticamente	prolepticamente	RG
proleticamente	proleticamente	RG
proliferamente	proliferamente	RG
prolificamente	prolificamente	RG
prolixamente	prolixamente	RG
prolongadamente	prolongadamente	RG
prometedoramente	prometedoramente	RG
promiscuamente	promiscuamente	RG
pronominalmente	pronominalmente	RG
prontamente	prontamente	RG
pronunciadamente	pronunciadamente	RG
propedeuticamente	propedeuticamente	RG
propiciamente	propiciamente	RG
proporcionadamente	proporcionadamente	RG
proporcionalmente	proporcionalmente	RG
propositadamente	propositadamente	RG
propositalmente	propositalmente	RG
propriamente	propriamente	RG
prosaicamente	prosaicamente	RG
prosodicamente	prosodicamente	RG
prosperamente	prosperamente	RG
prosperrimamente	prosperrimamente	RG
prosteticamente	prosteticamente	RG
protervamente	protervamente	RG
proteticamente	proteticamente	RG
protocolarmente	protocolarmente	RG
provadamente	provadamente	RG
provavelmente	provavelmente	RG
proveitosamente	proveitosamente	RG
proverbialmente	proverbialmente	RG
providamente	providamente	RG
providencialmente	providencialmente	RG
providentemente	providentemente	RG
provincialmente	provincialmente	RG
provincianamente	provincianamente	RG
provisionalmente	provisionalmente	RG
provisoriamente	provisoriamente	RG
provocadoramente	provocadoramente	RG
provocantemente	provocantemente	RG
provocatoriamente	provocatoriamente	RG
proximamente	proximamente	RG
prudencialmente	prudencialmente	RG
prudentemente	prudentemente	RG
pré-historicamente	pré-historicamente	RG
pseudonimamente	pseudonimamente	RG
psicologicamente	psicologicamente	RG
psiquiatricamente	psiquiatricamente	RG
psiquicamente	psiquicamente	RG
publicamente	publicamente	RG
puerilmente	puerilmente	RG
pujantemente	pujantemente	RG
pundonorosamente	pundonorosamente	RG
pungentemente	pungentemente	RG
punivelmente	punivelmente	RG
puramente	puramente	RG
puritanamente	puritanamente	RG
pusilanimemente	pusilanimemente	RG
putativamente	putativamente	RG
quadrangularmente	quadrangularmente	RG
quadrienalmente	quadrienalmente	RG
quadrimestralmente	quadrimestralmente	RG
quadruplicadamente	quadruplicadamente	RG
qualificadamente	qualificadamente	RG
qualificativamente	qualificativamente	RG
qualitativamente	qualitativamente	RG
quantiosamente	quantiosamente	RG
quantitativamente	quantitativamente	RG
quaresmalmente	quaresmalmente	RG
quebradamente	quebradamente	RG
queixosamente	queixosamente	RG
questionavelmente	questionavelmente	RG
quietamente	quietamente	RG
quilometricamente	quilometricamente	RG
quimericamente	quimericamente	RG
quimicamente	quimicamente	RG
quinquenalmente	quinquenalmente	RG
quinzenalmente	quinzenalmente	RG
quitemente	quitemente	RG
quixotescamente	quixotescamente	RG
quotidianamente	quotidianamente	RG
rabidamente	rabidamente	RG
racialmente	racialmente	RG
racionalmente	racionalmente	RG
racionavelmente	racionavelmente	RG
radialmente	radialmente	RG
radiantemente	radiantemente	RG
radicalmente	radicalmente	RG
radiofonicamente	radiofonicamente	RG
radiograficamente	radiograficamente	RG
radiologicamente	radiologicamente	RG
radiosamente	radiosamente	RG
radioscopicamente	radioscopicamente	RG
radiotelefonicamente	radiotelefonicamente	RG
radiotelegraficamente	radiotelegraficamente	RG
raivosamente	raivosamente	RG
rancorosamente	rancorosamente	RG
rapidamente	rapidamente	RG
rapsodicamente	rapsodicamente	RG
raquiticamente	raquiticamente	RG
raramente	raramente	RG
rasamente	rasamente	RG
rasgadamente	rasgadamente	RG
rasteiramente	rasteiramente	RG
razoadamente	razoadamente	RG
razoavelmente	razoavelmente	RG
reacionariamente	reacionariamente	RG
realengamente	realengamente	RG
realistamente	realistamente	RG
realisticamente	realisticamente	RG
realmente	realmente	RG
rebarbativamente	rebarbativamente	RG
rebeldemente	rebeldemente	RG
rebuscadamente	rebuscadamente	RG
rebuçadamente	rebuçadamente	RG
recalcadamente	recalcadamente	RG
recatadamente	recatadamente	RG
recentemente	recentemente	RG
receosamente	receosamente	RG
recessivamente	recessivamente	RG
reciprocamente	reciprocamente	RG
recolhidamente	recolhidamente	RG
recomendavelmente	recomendavelmente	RG
reconfortantemente	reconfortantemente	RG
reconhecidamente	reconhecidamente	RG
recordativamente	recordativamente	RG
recorrentemente	recorrentemente	RG
recreativamente	recreativamente	RG
recriminativamente	recriminativamente	RG
recriminatoriamente	recriminatoriamente	RG
rectangularmente	rectangularmente	RG
rectilineamente	rectilineamente	RG
recursivamente	recursivamente	RG
recurvadamente	recurvadamente	RG
redarguitivamente	redarguitivamente	RG
redobradamente	redobradamente	RG
redondamente	redondamente	RG
redundantemente	redundantemente	RG
redutivamente	redutivamente	RG
reduzidamente	reduzidamente	RG
refalsadamente	refalsadamente	RG
refecemente	refecemente	RG
referencialmente	referencialmente	RG
refertadamente	refertadamente	RG
refinadamente	refinadamente	RG
refletidamente	refletidamente	RG
reflexamente	reflexamente	RG
reflexivamente	reflexivamente	RG
reforçadamente	reforçadamente	RG
reforçativamente	reforçativamente	RG
refractariamente	refractariamente	RG
refratariamente	refratariamente	RG
regaladamente	regaladamente	RG
regiamente	regiamente	RG
regimentalmente	regimentalmente	RG
regionalmente	regionalmente	RG
regradamente	regradamente	RG
regressivamente	regressivamente	RG
regulamentarmente	regulamentarmente	RG
regularmente	regularmente	RG
reiteradamente	reiteradamente	RG
reiterativamente	reiterativamente	RG
relapsamente	relapsamente	RG
relativamente	relativamente	RG
relaxadamente	relaxadamente	RG
relesmente	relesmente	RG
relevantemente	relevantemente	RG
religiosamente	religiosamente	RG
relutantemente	relutantemente	RG
remansadamente	remansadamente	RG
remansosamente	remansosamente	RG
rematadamente	rematadamente	RG
remediadamente	remediadamente	RG
remediavelmente	remediavelmente	RG
remendadamente	remendadamente	RG
remexidamente	remexidamente	RG
remissamente	remissamente	RG
remissivamente	remissivamente	RG
remontadamente	remontadamente	RG
remotamente	remotamente	RG
remuneradoramente	remuneradoramente	RG
remuneravelmente	remuneravelmente	RG
rendidamente	rendidamente	RG
rendosamente	rendosamente	RG
renhidamente	renhidamente	RG
renitentemente	renitentemente	RG
repelentemente	repelentemente	RG
repentemente	repentemente	RG
repentinamente	repentinamente	RG
repetidamente	repetidamente	RG
repimpadamente	repimpadamente	RG
repisadamente	repisadamente	RG
repoisadamente	repoisadamente	RG
reportadamente	reportadamente	RG
repousadamente	repousadamente	RG
repreensivamente	repreensivamente	RG
repreensivelmente	repreensivelmente	RG
representativamente	representativamente	RG
repressivamente	repressivamente	RG
reprodutivamente	reprodutivamente	RG
republicanamente	republicanamente	RG
repugnantemente	repugnantemente	RG
repulsivamente	repulsivamente	RG
requebradamente	requebradamente	RG
requintadamente	requintadamente	RG
reservadamente	reservadamente	RG
resignadamente	resignadamente	RG
resistentemente	resistentemente	RG
resistivelmente	resistivelmente	RG
resolutamente	resolutamente	RG
resolvidamente	resolvidamente	RG
respectivamente	respectivamente	RG
respeitavelmente	respeitavelmente	RG
respeitosamente	respeitosamente	RG
respetivamente	respetivamente	RG
resplendorosamente	resplendorosamente	RG
responsavelmente	responsavelmente	RG
ressentidamente	ressentidamente	RG
ressequidamente	ressequidamente	RG
restritamente	restritamente	RG
restritivamente	restritivamente	RG
resumidamente	resumidamente	RG
retalhadamente	retalhadamente	RG
retamente	retamente	RG
retangularmente	retangularmente	RG
retardadamente	retardadamente	RG
reticenciosamente	reticenciosamente	RG
reticentemente	reticentemente	RG
retilineamente	retilineamente	RG
retintamente	retintamente	RG
retiradamente	retiradamente	RG
retorcidamente	retorcidamente	RG
retoricamente	retoricamente	RG
retractivamente	retractivamente	RG
retraidamente	retraidamente	RG
retrativamente	retrativamente	RG
retroativamente	retroativamente	RG
retrogradamente	retrogradamente	RG
retrospectivamente	retrospectivamente	RG
retrospetivamente	retrospetivamente	RG
retumbantemente	retumbantemente	RG
reverenciosamente	reverenciosamente	RG
reverentemente	reverentemente	RG
reversivamente	reversivamente	RG
revezadamente	revezadamente	RG
revocavelmente	revocavelmente	RG
revogavelmente	revogavelmente	RG
revoltantemente	revoltantemente	RG
revolucionariamente	revolucionariamente	RG
revulsivamente	revulsivamente	RG
ricamente	ricamente	RG
ridiculamente	ridiculamente	RG
rigidamente	rigidamente	RG
rigorosamente	rigorosamente	RG
rijamente	rijamente	RG
rimaticamente	rimaticamente	RG
risivelmente	risivelmente	RG
risonhamente	risonhamente	RG
rispidamente	rispidamente	RG
ritmadamente	ritmadamente	RG
ritmicamente	ritmicamente	RG
ritualmente	ritualmente	RG
robustamente	robustamente	RG
rogativamente	rogativamente	RG
rogatoriamente	rogatoriamente	RG
romanamente	romanamente	RG
romanescamente	romanescamente	RG
romanicamente	romanicamente	RG
romanisticamente	romanisticamente	RG
romanticamente	romanticamente	RG
ronceiramente	ronceiramente	RG
rotamente	rotamente	RG
rotativamente	rotativamente	RG
rotineiramente	rotineiramente	RG
rotundamente	rotundamente	RG
roucamente	roucamente	RG
roufenhamente	roufenhamente	RG
rubramente	rubramente	RG
rudamente	rudamente	RG
rudemente	rudemente	RG
rudimentarmente	rudimentarmente	RG
ruidosamente	ruidosamente	RG
ruimente	ruimente	RG
ruimmente	ruimmente	RG
ruinosamente	ruinosamente	RG
rumorosamente	rumorosamente	RG
ruralmente	ruralmente	RG
rusticamente	rusticamente	RG
rutilantemente	rutilantemente	RG
sabedoramente	sabedoramente	RG
sabiamente	sabiamente	RG
sabidamente	sabidamente	RG
saborosamente	saborosamente	RG
sacramentalmente	sacramentalmente	RG
sacrilegamente	sacrilegamente	RG
sacudidamente	sacudidamente	RG
sadiamente	sadiamente	RG
sadicamente	sadicamente	RG
saficamente	saficamente	RG
sagazmente	sagazmente	RG
sagesmente	sagesmente	RG
sagradamente	sagradamente	RG
salgadamente	salgadamente	RG
salientemente	salientemente	RG
salomonicamente	salomonicamente	RG
salteadamente	salteadamente	RG
saltitantemente	saltitantemente	RG
salubremente	salubremente	RG
salutarmente	salutarmente	RG
sandiamente	sandiamente	RG
sangrentamente	sangrentamente	RG
sanguinariamente	sanguinariamente	RG
sanguinolentamente	sanguinolentamente	RG
sanhudamente	sanhudamente	RG
sanitariamente	sanitariamente	RG
sanscriticamente	sanscriticamente	RG
santamente	santamente	RG
santanariamente	santanariamente	RG
sapientemente	sapientemente	RG
sarcasticamente	sarcasticamente	RG
sardonicamente	sardonicamente	RG
satanicamente	satanicamente	RG
satiricamente	satiricamente	RG
satisfatoriamente	satisfatoriamente	RG
saudavelmente	saudavelmente	RG
saudosamente	saudosamente	RG
sazonalmente	sazonalmente	RG
secamente	secamente	RG
seccionalmente	seccionalmente	RG
secretamente	secretamente	RG
secularmente	secularmente	RG
secundariamente	secundariamente	RG
sedentamente	sedentamente	RG
sedentariamente	sedentariamente	RG
sediciosamente	sediciosamente	RG
sedutoramente	sedutoramente	RG
segregativamente	segregativamente	RG
seguidamente	seguidamente	RG
seguintemente	seguintemente	RG
segundamente	segundamente	RG
seguramente	seguramente	RG
seletivamente	seletivamente	RG
selvaticamente	selvaticamente	RG
sem-cerimoniosamente	sem-cerimoniosamente	RG
semanalmente	semanalmente	RG
semanticamente	semanticamente	RG
semelhantemente	semelhantemente	RG
semenhantemente	semenhantemente	RG
semestralmente	semestralmente	RG
semiconsonanticamente	semiconsonanticamente	RG
seminaristicamente	seminaristicamente	RG
semioficialmente	semioficialmente	RG
semioficiosamente	semioficiosamente	RG
semiplenamente	semiplenamente	RG
semiticamente	semiticamente	RG
semivocalicamente	semivocalicamente	RG
sempiternamente	sempiternamente	RG
sempremente	sempremente	RG
senhorialmente	senhorialmente	RG
senhorilmente	senhorilmente	RG
sensaboronamente	sensaboronamente	RG
sensacionalmente	sensacionalmente	RG
sensatamente	sensatamente	RG
sensibilizadoramente	sensibilizadoramente	RG
sensivelmente	sensivelmente	RG
sensorialmente	sensorialmente	RG
sensualmente	sensualmente	RG
sentenciosamente	sentenciosamente	RG
sentidamente	sentidamente	RG
sentimentalmente	sentimentalmente	RG
separadamente	separadamente	RG
sequiosamente	sequiosamente	RG
seraficamente	seraficamente	RG
serenamente	serenamente	RG
seriamente	seriamente	RG
serodiamente	serodiamente	RG
servilmente	servilmente	RG
serviçalmente	serviçalmente	RG
sevamente	sevamente	RG
severamente	severamente	RG
sexenalmente	sexenalmente	RG
sexualmente	sexualmente	RG
sibariticamente	sibariticamente	RG
sibilantemente	sibilantemente	RG
sibilinamente	sibilinamente	RG
sigilosamente	sigilosamente	RG
significativamente	significativamente	RG
silabicamente	silabicamente	RG
silenciosamente	silenciosamente	RG
silogisticamente	silogisticamente	RG
simbioticamente	simbioticamente	RG
simbolicamente	simbolicamente	RG
simbolisticamente	simbolisticamente	RG
simetricamente	simetricamente	RG
simiescamente	simiescamente	RG
similarmente	similarmente	RG
simpaticamente	simpaticamente	RG
simplesmente	simplesmente	RG
simplicissimamente	simplicissimamente	RG
simplificadamente	simplificadamente	RG
simplificativamente	simplificativamente	RG
simplistamente	simplistamente	RG
simploriamente	simploriamente	RG
simpresmente	simpresmente	RG
simuladamente	simuladamente	RG
simulatoriamente	simulatoriamente	RG
simultaneamente	simultaneamente	RG
sinceramente	sinceramente	RG
sincliticamente	sincliticamente	RG
sincopadamente	sincopadamente	RG
sincreticamente	sincreticamente	RG
sincronicamente	sincronicamente	RG
sindeticamente	sindeticamente	RG
sindicalmente	sindicalmente	RG
sinergicamente	sinergicamente	RG
sinfonicamente	sinfonicamente	RG
singelamente	singelamente	RG
singularmente	singularmente	RG
sinistramente	sinistramente	RG
sinonimicamente	sinonimicamente	RG
sinopticamente	sinopticamente	RG
sinoticamente	sinoticamente	RG
sintacticamente	sintacticamente	RG
sintaticamente	sintaticamente	RG
sintaxicamente	sintaxicamente	RG
sinteticamente	sinteticamente	RG
sintomaticamente	sintomaticamente	RG
sinuosamente	sinuosamente	RG
sistematicamente	sistematicamente	RG
sisudamente	sisudamente	RG
sobejamente	sobejamente	RG
soberanamente	soberanamente	RG
soberbamente	soberbamente	RG
soberbosamente	soberbosamente	RG
sobradamente	sobradamente	RG
sobranceiramente	sobranceiramente	RG
sobrecelestialmente	sobrecelestialmente	RG
sobrelevantemente	sobrelevantemente	RG
sobrenaturalmente	sobrenaturalmente	RG
sobrepostamente	sobrepostamente	RG
sobrepujantemente	sobrepujantemente	RG
sobriamente	sobriamente	RG
socialmente	socialmente	RG
sociavelmente	sociavelmente	RG
socioeconomicamente	socioeconomicamente	RG
sociologicamente	sociologicamente	RG
socraticamente	socraticamente	RG
sofisticamente	sofisticamente	RG
sofregamente	sofregamente	RG
sofridamente	sofridamente	RG
sofrivelmente	sofrivelmente	RG
solapadamente	solapadamente	RG
soldadescamente	soldadescamente	RG
solenemente	solenemente	RG
solertemente	solertemente	RG
solicitamente	solicitamente	RG
solidamente	solidamente	RG
solidariamente	solidariamente	RG
solitariamente	solitariamente	RG
soltamente	soltamente	RG
solteiramente	solteiramente	RG
soluçadamente	soluçadamente	RG
somaticamente	somaticamente	RG
sombriamente	sombriamente	RG
somente	somente	RG
somiticamente	somiticamente	RG
sonambulamente	sonambulamente	RG
sonambulicamente	sonambulicamente	RG
sonegadamente	sonegadamente	RG
sonicamente	sonicamente	RG
sonolentamente	sonolentamente	RG
sonoramente	sonoramente	RG
sonorosamente	sonorosamente	RG
sonsamente	sonsamente	RG
sordidamente	sordidamente	RG
sornamente	sornamente	RG
sororalmente	sororalmente	RG
sorrateiramente	sorrateiramente	RG
sorridentemente	sorridentemente	RG
sorteadamente	sorteadamente	RG
sorumbaticamente	sorumbaticamente	RG
sossegadamente	sossegadamente	RG
sotilmente	sotilmente	RG
soturnamente	soturnamente	RG
sovieticamente	sovieticamente	RG
sovinamente	sovinamente	RG
suasoriamente	suasoriamente	RG
suavemente	suavemente	RG
sub-repticiamente	sub-repticiamente	RG
subalternamente	subalternamente	RG
subentendidamente	subentendidamente	RG
subidamente	subidamente	RG
subintencionalmente	subintencionalmente	RG
subitamente	subitamente	RG
subitaneamente	subitaneamente	RG
subjacentemente	subjacentemente	RG
subjetivamente	subjetivamente	RG
sublimadamente	sublimadamente	RG
sublimemente	sublimemente	RG
subliminarmente	subliminarmente	RG
sublinhadamente	sublinhadamente	RG
submissamente	submissamente	RG
subordinadamente	subordinadamente	RG
subordinantemente	subordinantemente	RG
subrepticiamente	subrepticiamente	RG
subsecutivamente	subsecutivamente	RG
subsequentemente	subsequentemente	RG
subservientemente	subservientemente	RG
subsidiariamente	subsidiariamente	RG
substancialmente	substancialmente	RG
substanciosamente	substanciosamente	RG
substantivamente	substantivamente	RG
subterraneamente	subterraneamente	RG
subtilmente	subtilmente	RG
subtrativamente	subtrativamente	RG
subversivamente	subversivamente	RG
sucedaneamente	sucedaneamente	RG
sucessivamente	sucessivamente	RG
sucessoriamente	sucessoriamente	RG
sucintamente	sucintamente	RG
suculentamente	suculentamente	RG
suficientemente	suficientemente	RG
sufragisticamente	sufragisticamente	RG
sugestivamente	sugestivamente	RG
suinamente	suinamente	RG
sujamente	sujamente	RG
sultanescamente	sultanescamente	RG
sumamente	sumamente	RG
sumariamente	sumariamente	RG
sumidamente	sumidamente	RG
sumptuariamente	sumptuariamente	RG
sumptuosamente	sumptuosamente	RG
suntuosamente	suntuosamente	RG
super-requintadamente	super-requintadamente	RG
superabundantemente	superabundantemente	RG
superficialmente	superficialmente	RG
superfluamente	superfluamente	RG
superiormente	superiormente	RG
superlativamente	superlativamente	RG
supersticiosamente	supersticiosamente	RG
supinamente	supinamente	RG
supitamente	supitamente	RG
suplementarmente	suplementarmente	RG
supletivamente	supletivamente	RG
supletoriamente	supletoriamente	RG
suplicantemente	suplicantemente	RG
suplicativamente	suplicativamente	RG
suplicatoriamente	suplicatoriamente	RG
suplicemente	suplicemente	RG
suportavelmente	suportavelmente	RG
supostamente	supostamente	RG
supranaturalmente	supranaturalmente	RG
supremamente	supremamente	RG
surdamente	surdamente	RG
surpreendentemente	surpreendentemente	RG
suspeitosamente	suspeitosamente	RG
suspicazmente	suspicazmente	RG
suspirosamente	suspirosamente	RG
sussurrantemente	sussurrantemente	RG
sutilmente	sutilmente	RG
sãmente	sãmente	RG
tabelioamente	tabelioamente	RG
tabelionicamente	tabelionicamente	RG
tabidamente	tabidamente	RG
tacanhamente	tacanhamente	RG
tacitamente	tacitamente	RG
taciturnamente	taciturnamente	RG
tacteadamente	tacteadamente	RG
tacticamente	tacticamente	RG
tactilmente	tactilmente	RG
tal-qualmente	tal-qualmente	RG
talentosamente	talentosamente	RG
talqualmente	talqualmente	RG
tangencialmente	tangencialmente	RG
tangivelmente	tangivelmente	RG
tantricamente	tantricamente	RM
taquigraficamente	taquigraficamente	RG
tardiamente	tardiamente	RG
tateadamente	tateadamente	RG
taticamente	taticamente	RG
tatilmente	tatilmente	RG
tauromaquicamente	tauromaquicamente	RG
tautologicamente	tautologicamente	RG
taxadamente	taxadamente	RG
taxativamente	taxativamente	RG
teatralmente	teatralmente	RG
tecnicamente	tecnicamente	RG
tecnologicamente	tecnologicamente	RG
tediosamente	tediosamente	RG
teimosamente	teimosamente	RG
telefonicamente	telefonicamente	RG
telegraficamente	telegraficamente	RG
telepaticamente	telepaticamente	RG
televisivamente	televisivamente	RG
tematicamente	tematicamente	RG
temente	temente	RG
temerariamente	temerariamente	RG
temerosamente	temerosamente	RG
temivelmente	temivelmente	RG
temperadamente	temperadamente	RG
tempestivamente	tempestivamente	RG
tempestuosamente	tempestuosamente	RG
temporalmente	temporalmente	RG
temporariamente	temporariamente	RG
temporãmente	temporãmente	RG
tenazmente	tenazmente	RG
tendencialmente	tendencialmente	RG
tendenciosamente	tendenciosamente	RG
tenebrosamente	tenebrosamente	RG
tenramente	tenramente	RG
tensamente	tensamente	RG
tentadoramente	tentadoramente	RG
tenuemente	tenuemente	RG
teocraticamente	teocraticamente	RG
teologalmente	teologalmente	RG
teologicamente	teologicamente	RG
teoreticamente	teoreticamente	RG
teoricamente	teoricamente	RG
tepidamente	tepidamente	RG
terapeuticamente	terapeuticamente	RG
terceiramente	terceiramente	RG
termicamente	termicamente	RG
terminantemente	terminantemente	RG
terminativamente	terminativamente	RG
ternamente	ternamente	RG
terrenamente	terrenamente	RG
terrestremente	terrestremente	RG
terrificamente	terrificamente	RG
territorialmente	territorialmente	RG
terrivelmente	terrivelmente	RG
tesamente	tesamente	RG
testemunhalmente	testemunhalmente	RG
tetanicamente	tetanicamente	RG
tetricamente	tetricamente	RG
teutonicamente	teutonicamente	RG
textualmente	textualmente	RG
teórico-praticamente	teórico-praticamente	RG
tibiamente	tibiamente	RG
timidamente	timidamente	RG
timoratamente	timoratamente	RG
tinhosamente	tinhosamente	RG
tipicamente	tipicamente	RG
tipograficamente	tipograficamente	RG
tiranamente	tiranamente	RG
tiranicamente	tiranicamente	RG
titanicamente	titanicamente	RG
titubeantemente	titubeantemente	RG
titularmente	titularmente	RG
tocantemente	tocantemente	RG
tolamente	tolamente	RG
toleradamente	toleradamente	RG
toleravelmente	toleravelmente	RG
tonalmente	tonalmente	RG
tonicamente	tonicamente	RG
topograficamente	topograficamente	RG
topologicamente	topologicamente	RG
toponimicamente	toponimicamente	RG
torcidamente	torcidamente	RG
tormentosamente	tormentosamente	RG
torpemente	torpemente	RG
torrencialmente	torrencialmente	RG
tortamente	tortamente	RG
tortuosamente	tortuosamente	RG
torturantemente	torturantemente	RG
torvamente	torvamente	RG
toscamente	toscamente	RG
tostemente	tostemente	RG
totalitariamente	totalitariamente	RG
totalmente	totalmente	RG
trabalhadamente	trabalhadamente	RG
trabalhosamente	trabalhosamente	RG
tradicionalmente	tradicionalmente	RG
tragicamente	tragicamente	RG
tragicomicamente	tragicomicamente	RG
traiçoeiramente	traiçoeiramente	RG
tranquilamente	tranquilamente	RG
tranquilizadoramente	tranquilizadoramente	RG
transcendentalmente	transcendentalmente	RG
transfusivamente	transfusivamente	RG
transgressivamente	transgressivamente	RG
transitivamente	transitivamente	RG
transitoriamente	transitoriamente	RG
translatamente	translatamente	RG
translucidamente	translucidamente	RG
transmissivelmente	transmissivelmente	RG
transordinariamente	transordinariamente	RG
transparentemente	transparentemente	RG
transversalmente	transversalmente	RG
transversamente	transversamente	RG
tratavelmente	tratavelmente	RG
traumaticamente	traumaticamente	RG
travadamente	travadamente	RG
travessamente	travessamente	RG
tredamente	tredamente	RG
tredoramente	tredoramente	RG
trefegamente	trefegamente	RG
tremendamente	tremendamente	RG
tremidamente	tremidamente	RG
tremulamente	tremulamente	RG
trepidamente	trepidamente	RG
trepidantemente	trepidantemente	RG
tresdobradamente	tresdobradamente	RG
tresloucadamente	tresloucadamente	RG
triangularmente	triangularmente	RG
trianualmente	trianualmente	RG
tributariamente	tributariamente	RG
trienalmente	trienalmente	RG
trigonometricamente	trigonometricamente	RG
trigosamente	trigosamente	RG
trimestralmente	trimestralmente	RG
tripeiramente	tripeiramente	RG
triplamente	triplamente	RG
triplicadamente	triplicadamente	RG
triplicemente	triplicemente	RG
trissilabicamente	trissilabicamente	RG
tristemente	tristemente	RG
triunfalmente	triunfalmente	RG
triunfantemente	triunfantemente	RG
trivialmente	trivialmente	RG
trocadamente	trocadamente	RG
tropegamente	tropegamente	RG
tropologicamente	tropologicamente	RG
truculentamente	truculentamente	RG
tudescamente	tudescamente	RG
tumidamente	tumidamente	RG
tumultuariamente	tumultuariamente	RG
tumultuosamente	tumultuosamente	RG
turbulentamente	turbulentamente	RG
turcamente	turcamente	RG
turgidamente	turgidamente	RG
turisticamente	turisticamente	RG
turvamente	turvamente	RG
ubiquamente	ubiquamente	RG
ufanamente	ufanamente	RG
ufanosamente	ufanosamente	RG
ulteriormente	ulteriormente	RG
ultimamente	ultimamente	RG
ultrajantemente	ultrajantemente	RG
ultrajosamente	ultrajosamente	RG
ultraliberalmente	ultraliberalmente	RG
ultrarrapidamente	ultrarrapidamente	RG
unamente	unamente	RG
unanimemente	unanimemente	RG
undulosamente	undulosamente	RG
unicamente	unicamente	RG
unidamente	unidamente	RG
uniformemente	uniformemente	RG
unilateralmente	unilateralmente	RG
unipessoalmente	unipessoalmente	RG
unissonamente	unissonamente	RG
unitariamente	unitariamente	RG
universalmente	universalmente	RG
universitariamente	universitariamente	RG
univocamente	univocamente	RG
untuosamente	untuosamente	RG
urbanamente	urbanamente	RG
urbanisticamente	urbanisticamente	RG
urgentemente	urgentemente	RG
usualmente	usualmente	RG
usurariamente	usurariamente	RG
utilitariamente	utilitariamente	RG
utilmente	utilmente	RG
utopicamente	utopicamente	RG
vacilantemente	vacilantemente	RG
vadiamente	vadiamente	RG
vagamente	vagamente	RG
vagarosamente	vagarosamente	RG
vaidosamente	vaidosamente	RG
valentemente	valentemente	RG
valerosamente	valerosamente	RG
validamente	validamente	RG
valiosamente	valiosamente	RG
valorosamente	valorosamente	RG
vandalicamente	vandalicamente	RG
vangloriosamente	vangloriosamente	RG
vantajosamente	vantajosamente	RG
vaporosamente	vaporosamente	RG
variadamente	variadamente	RG
variamente	variamente	RG
variavelmente	variavelmente	RG
variegadamente	variegadamente	RG
varonilmente	varonilmente	RG
vastamente	vastamente	RG
vaziamente	vaziamente	RG
veementemente	veementemente	RG
vegetativamente	vegetativamente	RG
veladamente	veladamente	RG
velhacamente	velhacamente	RG
velozmente	velozmente	RG
venalmente	venalmente	RG
venenosamente	venenosamente	RG
veneradamente	veneradamente	RG
veneravelmente	veneravelmente	RG
venialmente	venialmente	RG
venturosamente	venturosamente	RG
veramente	veramente	RG
verbalisticamente	verbalisticamente	RG
verbalmente	verbalmente	RG
verberantemente	verberantemente	RG
verbosamente	verbosamente	RG
verdadeiramente	verdadeiramente	RG
vergonhosamente	vergonhosamente	RG
veridicamente	veridicamente	RG
verisimilmente	verisimilmente	RG
verissimilmente	verissimilmente	RG
vernaculamente	vernaculamente	RG
verosimilmente	verosimilmente	RG
verossimilmente	verossimilmente	RG
verrinosamente	verrinosamente	RG
versatilmente	versatilmente	RG
verticalmente	verticalmente	RG
vertiginosamente	vertiginosamente	RG
vesgamente	vesgamente	RG
veterinariamente	veterinariamente	RG
vetustamente	vetustamente	RG
vexatoriamente	vexatoriamente	RG
vibrantemente	vibrantemente	RG
vibratoriamente	vibratoriamente	RG
viciosamente	viciosamente	RG
vigilantemente	vigilantemente	RG
vigorosamente	vigorosamente	RG
vilipendiosamente	vilipendiosamente	RG
vilmente	vilmente	RG
viloamente	viloamente	RG
vilãmente	vilãmente	RG
vincadamente	vincadamente	RG
vinculadamente	vinculadamente	RG
vindicativamente	vindicativamente	RG
vingativamente	vingativamente	RG
violentamente	violentamente	RG
viperinamente	viperinamente	RG
virginalmente	virginalmente	RG
virgineamente	virgineamente	RG
virilmente	virilmente	RG
virtualmente	virtualmente	RG
virtuosamente	virtuosamente	RG
virulentamente	virulentamente	RG
visceralmente	visceralmente	RG
visionariamente	visionariamente	RG
visivelmente	visivelmente	RG
vistosamente	vistosamente	RG
visualmente	visualmente	RG
vitaliciamente	vitaliciamente	RG
vitalmente	vitalmente	RG
vitoriosamente	vitoriosamente	RG
vituperiosamente	vituperiosamente	RG
vituperosamente	vituperosamente	RG
vivamente	vivamente	RG
vivazmente	vivazmente	RG
vividamente	vividamente	RG
vivificantemente	vivificantemente	RG
viçosamente	viçosamente	RG
vocabularmente	vocabularmente	RG
vocalicamente	vocalicamente	RG
vocalmente	vocalmente	RG
vocativamente	vocativamente	RG
volumetricamente	volumetricamente	RG
volumosamente	volumosamente	RG
voluntariamente	voluntariamente	RG
voluntariosamente	voluntariosamente	RG
voluptuariamente	voluptuariamente	RG
voluptuosamente	voluptuosamente	RG
volutuosamente	volutuosamente	RG
voluvelmente	voluvelmente	RG
vorazmente	vorazmente	RG
votivamente	votivamente	RG
vulcanicamente	vulcanicamente	RG
vulgarmente	vulgarmente	RG
vulneravelmente	vulneravelmente	RG
vultosamente	vultosamente	RG
vultuosamente	vultuosamente	RG
vulturinamente	vulturinamente	RG
vãmente	vãmente	RG
zelosamente	zelosamente	RG
zombeteiramente	zombeteiramente	RG
zoologicamente	zoologicamente	RG
