Adeus	Adeus	I
Adiante	Adiante	I
Agradecida	Agradecido	I
Agradecidas	Agradecido	I
Agradecido	Agradecido	I
Agradecidos	Agradecido	I
Ah	Ah	I
Ai	Ai	I
Aicarai	Aicarai	I
Alerta	Alerta	I
Ali	Ali	I
Alto	Alto	I
Alô	Alô	I
Apoiado	Apoiado	I
Apre	Apre	I
Argh	Argh	I
Arre	Arre	I
Avante	Avante	I
Ave	Ave	I
Basta	Basta	I
Basta	basta	I
Bem	Bem	I
Bis	Bis	I
Bora	Bora	I
Bravo	Bravo	I
Calada	Calada	I
Calma	Calma	I
Caraca	Caraca	I
Caralho	Caralho	I
Caramba	Caramba	I
Chega	Chega	I
Chega	chega	I
Chi	Chi	I
Chiça	Chiça	I
Como	Como	I
Coragem	Coragem	I
Credo	Credo	I
Cruzes	Cruzes	I
Cuidado	Cuidado	I
Céus	Céus	I
Desculpa	Desculpa	I
Desculpe	Desculpe	I
Diabo	Diabo	I
Eba	Eba	I
Eh	Eh	I
Ei	Ei	I
Eia	Eia	I
Eita	Eita	I
Exatamente	Exatamente	I
Firme	Firme	I
Fiufiu	Fiufiu	I
Fogo	Fogo	I
Força	Força	I
Francamente	Francamente	I
Gente	Gente	I
Gol	Gol	I
Hei	Hei	I
Hem	Hem	I
Hum	Hum	I
Hup	Hup	I
Hurra	Hurra	I
Hã	Hã	I
Ih	Ih	I
Inteirinho	Inteirinho	I
Isso	Isso	I
Iupi	Iupi	I
Jesus	Jesus	I
Merda	Merda	I
Mesmo	Mesmo	I
Nossa	Nossa	I
OK	OK	I
Oba	Oba	I
Obrigada	Obrigada	I
Obrigado	Obrigado	I
Oh	Oh	I
Oi	Oi	I
Oiê	Oiê	I
Ok	ok	I
Olha	Olha	I
Olá	Olá	I
Onde	Onde	I
Opa	Opa	I
Ora	Ora	I
Oxalá	Oxalá	I
Parabéns	Parabéns	I
Perdão	Perdão	I
Poxa	Poxa	I
Psit	Psit	I
Psiu	Psiu	I
Pudera	Pudera	I
Puts	Puts	I
Puxa	Puxa	I
Pára	pára	I
Pô	Pô	I
Que	Que	I
Quem	Quem	I
Quietos	Quietos	I
Quê	Quê	I
Raios	Raios	I
Salve	Salve	I
Shh	Shh	I
Silêncio	Silêncio	I
Socorro	Socorro	I
Stop	Stop	I
Tchau	Tchau	I
Toca	Toca	I
Tomara	Tomara	I
Uai	Uai	I
Uf	Uf	I
Ufa	Ufa	I
Uh	Uh	I
UhUau	UhUau	I
Uhu	Uhu	I
Ui	Ui	I
Upa	Upa	I
Ué	Ué	I
Valeu	Valeu	I
Vamos	Vamos	I
Viva	Viva	I
Xi	Xi	I
abafa	abafa	I
abaixo	abaixo	I
aboca	aboca	I
abracadabra	abracadabra	I
abrenúncio	abrenúncio	I
acima	acima	I
adei	adei	I
adeus	adeus	I
adiante	adiante	I
afasta	afasta	I
ah	ah	I
ai	ai	I
ailó	ailó	I
ala	ala	I
aleluia	aleluia	I
alerta	alerta	I
alevá	alevá	I
alivia	alivia	I
alto	alto	I
alô	alô	I
amen	amen	I
amém	amém	I
amén	amén	I
arre	arre	I
arreda	arreda	I
arrenego	arrenego	I
arriba	arriba	I
asta	asta	I
avante	avante	I
ave	ave	I
avonda	avonda	I
aí	aí	I
babau	babau	I
basta	basta	I
beleza	beleza	I
bem	bem	I
bimba	bimba	I
bis	bis	I
blz	blz	I
boa	boa	I
bolas	bolas	I
bonda	bonda	I
bravo	bravo	I
brevemente	brevemente	I
bum	bum	I
bumba	bumba	I
cachapuz	cachapuz	I
cachicha	cachicha	I
calar	calar	I
caluda	caluda	I
canté	canté	I
cantés	cantés	I
caput	caput	I
carago	carago	I
caralho	caralho	I
caralhão	caralhão	I
caralhões	caralhões	I
caramba	caramba	I
caraças	caraças	I
carrega	carrega	I
caspité	caspité	I
catano	catano	I
catapus	catapus	I
catatraz	catatraz	I
catrâmbias	catrâmbias	I
cebolório	cebolório	I
chape	chape	I
chapéu	chapéu	I
chau	chau	I
chega	chega	I
chitom	chitom	I
chitão	chitão	I
chiu	chiu	I
chiça	chiça	I
chupa	chupa	I
chut	chut	I
chuta	chuta	I
chuts	chut	I
ché	ché	I
como	como	I
contro	contro	I
cruzes	cruzes	I
cuidado	cuidado	I
dah	dah	I
dlim	dlim	I
domisteco	domisteco	I
eh	eh	I
ei	ei	I
eia	eia	I
eixe	eixe	I
embora	embora	I
ena	ena	I
então	então	I
epa	epa	I
eureka	eureka	I
exactamente	exactamente	I
fasta	fasta	I
figas	figas	I
fixe	fixe	I
fogo	fogo	I
fora	fora	I
força	força	I
fu	fu	I
fum	fum	I
fó	fó	I
fónix	fónix	I
fônix	fônix	I
garré	garré	I
guai	guai	I
hail	hail	I
heil	heil	I
hem	hem	I
heureca	heureca	I
him	him	I
hip	hip	I
homessa	homessa	I
hou	hou	I
hui	hui	I
hum	hum	I
hurra	hurra	I
hálas	hálas	I
hã	hã	I
ih	ih	I
inté	inté	I
irra	irra	I
jesus	jesus	I
já	já	I
livra	livra	I
melhor	melhor	I
moita	moita	I
morra	morra	I
nham	nham	I
né	né	I
obrigada	obrigada	I
obrigadinho	obrigadinho	I
obrigado	obrigado	I
oh	oh	I
ok	ok	I
olarila	olarila	I
olaré	olaré	I
olhe	olhe	I
olá	olá	I
olé	olé	I
omg	omg	I
ora	ora	I
ordem	ordem	I
ordinário	ordinário	I
oxalá	oxalá	I
paciência	paciência	I
palavrinha	palavrinha	I
pardeus	pardeus	I
pardês	pardês	I
pila	pila	I
pimba	pimba	I
poche	poche	I
poh	poh	I
pois	pois	I
porra	porra	I
poxa	poxa	I
pronto	pronto	I
psiu	psiu	I
pudera	pudera	I
puf	puf	I
pum	pum	I
pumba	pumba	I
pá	pá	I
péu	péu	I
qual	qual	I
ruda	ruda	I
ruh	ruh	I
ruma	ruma	I
safa	safa	I
salve	salve	I
santiago	santiago	I
sape	sape	I
saudade	saudade	I
sebo	sebo	I
seja	seja	I
sentido	sentido	I
silêncio	silêncio	I
sim	sim	I
soco	soco	I
stop	stop	I
sus	sus	I
também	também	I
tarrenego	tarrenego	I
tate	tate	I
tatá	tatá	I
tau	tau	I
tesconjuro	tesconjuro	I
trape	trape	I
trapuz	trapuz	I
tris	tris	I
truz	truz	I
trás	trás	I
tum	tum	I
tura	tura	I
tá	tá	I
tó	tó	I
uf	uf	I
ufa	ufa	I
uff	uff	I
uh	uh	I
ui	ui	I
upa	upa	I
ups	ups	I
uxte	uxte	I
viva	viva	I
vonda	vonda	I
vá	vá	I
víspere	víspere	I
wtf	wtf	I
xetá	xetá	I
xiu	xiu	I
xote	xote	I
xó	xó	I
xô	xô	I
yeah	yeah	I
zape	zape	I
zumba	zumba	I
zupa	zupa	I
zurre	zurre	I
zus	zus	I
zás	zás	I
zúquete	zúquete	I
Ânimo	Ânimo	I
Ó	Ó	I
Ôrra	Ôrra	I
àgora	àgora	I
ápage	ápage	I
ó	ó	I
